Source Port,Destination Port,NAT Source Port,NAT Destination Port,Action,Bytes,Bytes Sent,Bytes Received,Packets,Elapsed Time (sec),pkts_sent,pkts_received
47053,80,59078,80,allow,1188,463,725,8,15,5,3
54306,445,0,0,drop,70,70,0,1,0,1,0
31410,25174,0,0,deny,62,62,0,1,0,1,0
57732,445,0,0,drop,70,70,0,1,0,1,0
61593,445,0,0,drop,66,66,0,1,0,1,0
24378,5169,24378,5169,deny,507,507,0,1,0,1,0
50669,53,9177,53,allow,578,286,292,9,16,5,4
58478,443,30017,443,allow,19356,2148,17208,34,112,17,17
65222,53,8527,53,allow,212,102,110,2,30,1,1
443,54507,0,0,deny,82,82,0,1,0,1,0
53721,443,6188,443,allow,70,70,0,1,4,1,0
62456,443,40302,443,allow,8678,3253,5425,22,25,11,11
55056,80,55056,80,allow,2959,1505,1454,10,16,6,4
58638,5900,0,0,deny,62,62,0,1,0,1,0
50121,443,24047,443,allow,307104860,2750998,304353862,234597,6122,15017,219580
63708,445,0,0,drop,70,70,0,1,0,1,0
5176,53,35292,53,allow,86,86,0,1,30,1,0
2332,35440,0,0,deny,62,62,0,1,0,1,0
64710,53,1727,53,allow,195,102,93,2,29,1,1
53902,445,0,0,drop,70,70,0,1,0,1,0
51845,80,51845,80,allow,28037,2069,25968,40,26,16,24
63403,443,54530,443,allow,4470,1597,2873,16,138,8,8
53373,53,58629,53,allow,242,78,164,2,29,1,1
55831,53,12169,53,allow,182,93,89,2,31,1,1
52050,11392,0,0,deny,62,62,0,1,0,1,0
49459,443,42939,443,allow,2572,330,2242,12,135,5,7
51209,443,64337,443,allow,84768,21103,63665,136,133,58,78
59287,445,0,0,drop,70,70,0,1,0,1,0
62339,25174,0,0,deny,62,62,0,1,0,1,0
40687,64147,0,0,deny,62,62,0,1,0,1,0
62384,445,0,0,drop,70,70,0,1,0,1,0
55207,445,0,0,drop,70,70,0,1,0,1,0
53831,443,42938,443,allow,190,70,120,4,15,2,2
57396,53,17014,53,allow,212,102,110,2,30,1,1
65061,53,60210,53,allow,733,204,529,6,40,3,3
23632,64147,0,0,deny,66,66,0,1,0,1,0
56310,53,55159,53,allow,760,97,663,2,31,1,1
60192,53,4239,53,allow,236,94,142,2,30,1,1
11228,25174,0,0,deny,66,66,0,1,0,1,0
64330,53,63113,53,allow,200,94,106,2,29,1,1
51614,15000,49065,15000,allow,130,70,60,2,5,1,1
57470,46487,30671,46487,allow,527,166,361,2,1200,1,1
59835,53,53528,53,allow,168,78,90,2,30,1,1
35336,443,36436,443,allow,6821,1076,5745,21,27,12,9
57064,443,57064,443,allow,4378,1471,2907,19,29,11,8
37390,80,53231,80,allow,78,78,0,1,5,1,0
55224,53,5980,53,allow,209,110,99,2,30,1,1
55199,53,24591,53,allow,152,78,74,2,29,1,1
55655,53,4325,53,allow,524,214,310,6,57,3,3
11677,56205,0,0,deny,62,62,0,1,0,1,0
65056,53,56800,53,allow,270,94,176,2,30,1,1
64653,53,37901,53,allow,755,93,662,2,31,1,1
45652,10214,0,0,deny,62,62,0,1,0,1,0
57396,53,31064,53,allow,183,94,89,2,30,1,1
57887,53,44516,53,allow,174,81,93,2,30,1,1
60917,445,0,0,drop,70,70,0,1,0,1,0
49162,53,42033,53,allow,182,93,89,2,30,1,1
55072,53,55776,53,allow,177,94,83,2,30,1,1
8892,443,11185,443,allow,8106,1626,6480,31,341,11,20
54986,445,0,0,drop,70,70,0,1,0,1,0
48706,23393,0,0,deny,60,60,0,1,0,1,0
52147,445,0,0,drop,70,70,0,1,0,1,0
50920,445,0,0,drop,66,66,0,1,0,1,0
54677,443,30863,443,allow,72676,12694,59982,144,127,64,80
57797,64147,0,0,deny,66,66,0,1,0,1,0
50674,443,55479,443,allow,8709,1708,7001,22,19,11,11
58880,443,32825,443,allow,1413,876,537,12,11,6,6
52264,445,0,0,drop,70,70,0,1,0,1,0
50039,7000,50039,7000,allow,3050,1659,1391,16,15,9,7
36026,443,14720,443,allow,7050,984,6066,18,39,12,6
26722,11446,0,0,deny,62,62,0,1,0,1,0
55705,53,57706,53,allow,202,103,99,2,31,1,1
51221,51413,53021,51413,allow,460,150,310,2,1200,1,1
1956,53,1956,53,allow,240,98,142,2,30,1,1
16370,56205,0,0,deny,62,62,0,1,0,1,0
56739,443,22996,443,allow,795,795,0,2,169,2,0
6881,6881,0,0,deny,62,62,0,1,0,1,0
61740,445,0,0,drop,70,70,0,1,0,1,0
58250,35440,0,0,deny,66,66,0,1,0,1,0
55555,53,39560,53,allow,188,96,92,2,31,1,1
58521,445,0,0,drop,70,70,0,1,0,1,0
59889,30188,0,0,deny,66,66,0,1,0,1,0
14341,80,14341,80,allow,3360,2260,1100,19,61,11,8
53912,443,53912,443,allow,4447,1540,2907,19,30,11,8
53935,42874,31408,42874,allow,1973,1021,952,10,15,6,4
52038,50584,0,0,deny,66,66,0,1,0,1,0
60492,443,48948,443,allow,81016,8373,72643,122,339,57,65
57470,35667,24783,35667,allow,132,132,0,3,1200,3,0
58012,5555,0,0,deny,60,60,0,1,0,1,0
54013,445,0,0,drop,66,66,0,1,0,1,0
58284,445,0,0,drop,70,70,0,1,0,1,0
55088,53,51001,53,allow,177,94,83,2,29,1,1
64140,53,44344,53,allow,184,94,90,2,31,1,1
61788,445,0,0,drop,66,66,0,1,0,1,0
56853,443,46609,443,allow,7092,1795,5297,25,32,14,11
1687,25174,0,0,deny,146,146,0,1,0,1,0
44320,443,12809,443,allow,7244,1861,5383,26,330,14,12
55113,53,41095,53,allow,198,102,96,2,29,1,1
55127,445,0,0,drop,70,70,0,1,0,1,0
55377,3389,55377,3389,allow,3343,1454,1889,15,16,8,7
64226,53,54672,53,allow,245,94,151,2,30,1,1
55663,44847,0,0,deny,62,62,0,1,0,1,0
36351,80,36351,80,allow,1920,1471,449,10,20,6,4
8592,35993,0,0,deny,66,66,0,1,0,1,0
60697,445,0,0,drop,66,66,0,1,0,1,0
54752,445,0,0,drop,70,70,0,1,0,1,0
63962,53,21344,53,allow,185,93,92,3,58,2,1
48206,53,48206,53,allow,253,99,154,2,30,1,1
52630,1433,0,0,deny,60,60,0,1,0,1,0
63945,53,11861,53,allow,216,110,106,2,31,1,1
49650,53,24810,53,allow,216,110,106,2,29,1,1
58999,443,40792,443,allow,9569,2606,6963,22,135,11,11
53730,37096,48081,37096,allow,70,70,0,1,4,1,0
30644,25174,0,0,deny,62,62,0,1,0,1,0
25296,51505,0,0,deny,66,66,0,1,0,1,0
65534,53,65534,53,allow,414,268,146,3,31,2,1
57726,37965,0,0,deny,62,62,0,1,0,1,0
52082,14804,24933,14804,allow,70,70,0,1,4,1,0
63703,445,0,0,drop,70,70,0,1,0,1,0
55367,443,46972,443,allow,101466,17775,83691,225,74,112,113
62639,445,0,0,drop,70,70,0,1,0,1,0
49159,53,33263,53,allow,733,86,647,2,31,1,1
47046,80,21371,80,allow,1114,534,580,12,15,7,5
5588,5588,0,0,allow,3354,1792,1562,46,195,23,23
40183,443,34811,443,allow,6065,2277,3788,17,135,8,9
24351,57470,0,0,deny,62,62,0,1,0,1,0
50351,445,0,0,drop,70,70,0,1,0,1,0
44816,80,47339,80,allow,130,70,60,2,15,1,1
40218,443,5218,443,allow,5254,927,4327,20,84,9,11
59383,445,0,0,drop,66,66,0,1,0,1,0
53814,6725,2877,6725,allow,70,70,0,2,7,2,0
61202,35894,0,0,deny,66,66,0,1,0,1,0
49646,53,18495,53,allow,199,102,97,2,30,1,1
49516,445,0,0,drop,70,70,0,1,0,1,0
63097,44847,0,0,deny,62,62,0,1,0,1,0
59962,445,0,0,drop,70,70,0,1,0,1,0
55548,53,39542,53,allow,197,102,95,2,35,1,1
61465,445,0,0,drop,70,70,0,1,0,1,0
44256,3389,44256,3389,allow,4145,1976,2169,22,18,13,9
31675,19473,0,0,deny,145,145,0,1,0,1,0
58632,445,0,0,drop,70,70,0,1,0,1,0
50883,80,50883,80,allow,514,246,268,9,42,5,4
64729,445,0,0,drop,66,66,0,1,0,1,0
51048,445,0,0,drop,70,70,0,1,0,1,0
51909,33509,56937,33509,allow,70,70,0,1,5,1,0
51913,445,0,0,drop,70,70,0,1,0,1,0
49196,53,15790,53,allow,181,94,87,2,33,1,1
65335,445,0,0,drop,70,70,0,1,0,1,0
58305,445,0,0,drop,70,70,0,1,0,1,0
56609,443,13546,443,allow,11061,1566,9495,25,19,13,12
6881,6881,0,0,deny,146,146,0,1,0,1,0
64255,53,15083,53,allow,260,86,174,2,30,1,1
57247,445,0,0,drop,66,66,0,1,0,1,0
65427,53,25865,53,allow,677,188,489,6,57,3,3
52070,443,55434,443,allow,8971,4228,4743,20,95,12,8
54346,44847,0,0,deny,66,66,0,1,0,1,0
63286,445,0,0,drop,70,70,0,1,0,1,0
64486,445,0,0,drop,66,66,0,1,0,1,0
51098,80,4123,80,allow,3378,1918,1460,33,131,18,15
62341,26467,0,0,deny,66,66,0,1,0,1,0
24351,57470,0,0,deny,62,62,0,1,0,1,0
5180,80,5180,80,allow,33443,797,32646,33,16,9,24
42344,48637,0,0,deny,60,60,0,1,0,1,0
61635,37965,0,0,deny,66,66,0,1,0,1,0
55491,445,0,0,drop,70,70,0,1,0,1,0
1537,22114,0,0,deny,62,62,0,1,0,1,0
45964,2225,0,0,deny,60,60,0,1,0,1,0
49628,445,0,0,drop,70,70,0,1,0,1,0
19858,64147,0,0,deny,62,62,0,1,0,1,0
50394,445,0,0,drop,70,70,0,1,0,1,0
52862,80,51424,80,allow,3150,1478,1672,32,131,17,15
64347,53,53125,53,allow,193,102,91,2,29,1,1
51221,64767,41578,64767,allow,330,330,0,6,1200,6,0
65489,445,0,0,drop,70,70,0,1,0,1,0
64903,445,0,0,drop,70,70,0,1,0,1,0
52643,15941,0,0,deny,62,62,0,1,0,1,0
52990,443,9852,443,allow,7093,2235,4858,39,111,20,19
1028,64147,0,0,deny,62,62,0,1,0,1,0
51687,80,38806,80,allow,1517,481,1036,11,15,6,5
5223,59023,0,0,deny,66,66,0,1,0,1,0
61463,445,0,0,drop,66,66,0,1,0,1,0
64885,53,54457,53,allow,182,102,80,2,31,1,1
42298,40031,52392,40031,allow,156,94,62,2,30,1,1
58249,443,60364,443,allow,4220,2048,2172,11,122,6,5
65080,53,46581,53,allow,741,94,647,2,30,1,1
17581,23,0,0,deny,60,60,0,1,0,1,0
58453,50584,0,0,deny,66,66,0,1,0,1,0
9506,2323,0,0,deny,60,60,0,1,0,1,0
55010,443,19028,443,allow,7651,2261,5390,41,255,21,20
55656,53,7470,53,allow,214,110,104,2,30,1,1
50310,80,55858,80,allow,7979,802,7177,17,57,8,9
33804,443,22331,443,allow,5815,1128,4687,19,0,9,10
37592,36829,0,0,deny,146,146,0,1,0,1,0
56476,443,56476,443,allow,4624,1717,2907,19,30,11,8
46330,56205,0,0,deny,146,146,0,1,0,1,0
55632,45682,28003,45682,allow,70,70,0,2,8,2,0
64788,43890,0,0,deny,66,66,0,1,0,1,0
16654,50265,0,0,deny,62,62,0,1,0,1,0
54942,53,0,0,allow,168,74,94,2,30,1,1
60650,445,0,0,drop,70,70,0,1,0,1,0
61423,443,8022,443,allow,1113,589,524,12,28,6,6
54912,80,63649,80,allow,1992,1350,642,10,15,5,5
57554,445,0,0,drop,66,66,0,1,0,1,0
32156,51505,0,0,deny,146,146,0,1,0,1,0
56272,53,13597,53,allow,193,102,91,2,31,1,1
37965,1052,51562,1052,allow,132,132,0,3,1199,3,0
13021,25174,0,0,deny,62,62,0,1,0,1,0
65449,53,25371,53,allow,170,87,83,2,31,1,1
63927,50265,0,0,deny,62,62,0,1,0,1,0
53376,443,49944,443,allow,4814,1207,3607,17,75,10,7
57273,445,0,0,drop,66,66,0,1,0,1,0
5223,32965,0,0,deny,167,167,0,1,0,1,0
60429,445,0,0,drop,70,70,0,1,0,1,0
48287,443,53104,443,allow,416,210,206,7,96,4,3
33812,443,2950,443,allow,16120,8754,7366,36,327,21,15
53598,40326,59380,40326,allow,70,70,0,1,4,1,0
9957,32480,0,0,deny,62,62,0,1,0,1,0
55413,53,9671,53,allow,216,110,106,2,31,1,1
17750,12550,53024,12550,allow,491,150,341,2,1200,1,1
33237,443,28944,443,allow,31065,6730,24335,68,18,37,31
57146,53,5349,53,allow,199,102,97,2,29,1,1
51564,50584,0,0,deny,66,66,0,1,0,1,0
56336,53,18502,53,allow,192,98,94,2,30,1,1
48817,18529,48817,18529,allow,152,152,0,1,1200,1,0
40988,60043,0,0,deny,146,146,0,1,0,1,0
61441,443,10709,443,allow,7832,1143,6689,19,31,9,10
58470,445,0,0,drop,70,70,0,1,0,1,0
55879,53,11765,53,allow,184,94,90,2,30,1,1
63080,37965,0,0,deny,66,66,0,1,0,1,0
6356,26467,0,0,deny,62,62,0,1,0,1,0
57005,445,0,0,drop,70,70,0,1,0,1,0
61185,54532,0,0,deny,62,62,0,1,0,1,0
55171,53,21824,53,allow,198,101,97,2,31,1,1
49234,53,17547,53,allow,166,85,81,2,31,1,1
56486,80,1722,80,allow,46682,3447,43235,61,135,27,34
6486,64147,0,0,deny,62,62,0,1,0,1,0
65040,53,64754,53,allow,749,94,655,2,30,1,1
40806,443,37490,443,allow,3287,2049,1238,12,31,7,5
33919,53,58115,53,allow,168,78,90,2,30,1,1
64641,445,0,0,drop,70,70,0,1,0,1,0
22240,22114,0,0,deny,146,146,0,1,0,1,0
27005,27212,63313,27212,allow,889,126,763,2,30,1,1
50303,445,0,0,drop,66,66,0,1,0,1,0
55492,53,58378,53,allow,760,96,664,2,31,1,1
52257,6712,42589,6712,allow,70,70,0,2,8,2,0
26900,27017,44088,27017,allow,250,164,86,4,30,3,1
56418,53,28996,53,allow,183,94,89,2,31,1,1
55070,80,64489,80,allow,246,120,126,5,16,3,2
59789,445,0,0,drop,70,70,0,1,0,1,0
61827,443,61827,443,allow,56634,10853,45781,76,175,34,42
9524,443,1427,443,allow,1313,876,437,11,26,6,5
61979,445,0,0,drop,66,66,0,1,0,1,0
64034,53,38664,53,allow,194,102,92,2,29,1,1
59744,80,14710,80,allow,699554,16426,683128,701,95,244,457
55647,53,8145,53,allow,168,86,82,2,30,1,1
64580,53,13673,53,allow,199,102,97,2,30,1,1
62407,445,0,0,drop,70,70,0,1,0,1,0
51985,445,0,0,drop,70,70,0,1,0,1,0
13559,57866,0,0,deny,66,66,0,1,0,1,0
59165,445,0,0,drop,70,70,0,1,0,1,0
53467,445,0,0,drop,70,70,0,1,0,1,0
64619,53,54626,53,allow,174,89,85,2,31,1,1
62885,62413,0,0,deny,66,66,0,1,0,1,0
64449,53,61840,53,allow,197,94,103,2,30,1,1
38358,22300,0,0,deny,60,60,0,1,0,1,0
49522,21247,0,0,deny,62,62,0,1,0,1,0
61803,445,0,0,drop,66,66,0,1,0,1,0
52526,30188,0,0,deny,66,66,0,1,0,1,0
57987,56125,0,0,deny,90,90,0,1,0,1,0
26953,30317,0,0,deny,62,62,0,1,0,1,0
27005,27015,28442,27015,allow,881,126,755,2,31,1,1
64724,443,50877,443,allow,8602,1050,7552,16,121,7,9
53664,13701,27246,13701,allow,70,70,0,2,8,2,0
3478,61463,0,0,deny,1012,1012,0,1,0,1,0
55413,53,32368,53,allow,216,110,106,2,31,1,1
38774,80,38774,80,allow,369073,4523,364550,316,142,59,257
56863,53,12002,53,allow,177,94,83,2,31,1,1
53260,36237,0,0,deny,62,62,0,1,0,1,0
55169,53,40051,53,allow,199,102,97,2,30,1,1
54602,445,0,0,drop,66,66,0,1,0,1,0
53530,8999,38471,8999,allow,70,70,0,2,7,2,0
55431,53,28791,53,allow,192,98,94,2,30,1,1
51270,48061,59473,48061,allow,70,70,0,2,8,2,0
49495,53,39798,53,allow,758,102,656,2,31,1,1
59394,443,52019,443,allow,5993,1987,4006,17,26,9,8
53236,443,53236,443,allow,1210,637,573,14,34,7,7
32770,51505,0,0,deny,62,62,0,1,0,1,0
54391,445,0,0,drop,70,70,0,1,0,1,0
49192,53,8580,53,allow,212,102,110,2,30,1,1
64722,53,7575,53,allow,184,94,90,2,30,1,1
59581,53,59581,53,allow,823,98,725,2,29,1,1
32866,443,34870,443,allow,23467,16522,6945,51,161,29,22
61560,445,0,0,drop,70,70,0,1,0,1,0
60003,443,18889,443,allow,32538,7037,25501,49,143,20,29
55126,53,57162,53,allow,177,94,83,2,30,1,1
55271,53,23423,53,allow,168,86,82,2,30,1,1
48448,48817,0,0,deny,66,66,0,1,0,1,0
49483,53,48622,53,allow,178,94,84,2,30,1,1
56964,53,51072,53,allow,174,89,85,2,31,1,1
35120,26467,0,0,deny,62,62,0,1,0,1,0
64025,53,10807,53,allow,199,94,105,2,30,1,1
64299,53,27762,53,allow,164,84,80,2,31,1,1
64727,443,24002,443,allow,18620,15824,2796,31,129,18,13
33973,50265,0,0,deny,62,62,0,1,0,1,0
49790,53,24988,53,allow,190,97,93,2,30,1,1
7288,25174,0,0,deny,66,66,0,1,0,1,0
33884,53,0,0,allow,86,86,0,1,30,1,0
52066,60118,24886,60118,allow,70,70,0,2,8,2,0
39818,443,44736,443,allow,2211,1181,1030,23,40,11,12
51097,445,0,0,drop,70,70,0,1,0,1,0
57307,53,14179,53,allow,177,94,83,2,30,1,1
27005,27016,32182,27016,allow,1648,126,1522,4,30,2,2
34808,22114,0,0,deny,66,66,0,1,0,1,0
64724,53,50975,53,allow,195,102,93,2,31,1,1
51904,445,0,0,drop,70,70,0,1,0,1,0
64683,53,49305,53,allow,821,102,719,2,29,1,1
10151,10016,24460,10016,allow,460,150,310,2,1200,1,1
56660,445,0,0,drop,66,66,0,1,0,1,0
60501,40829,17093,40829,allow,70,70,0,1,5,1,0
22733,26467,0,0,deny,62,62,0,1,0,1,0
62273,445,0,0,drop,70,70,0,1,0,1,0
60741,445,0,0,drop,70,70,0,1,0,1,0
49944,53,20178,53,allow,192,98,94,2,31,1,1
49899,443,2357,443,allow,26284,21857,4427,72,83,39,33
49928,443,36059,443,allow,11646,4774,6872,29,32,18,11
55668,80,2182,80,allow,70,70,0,2,8,2,0
50850,443,34368,443,allow,6341,1382,4959,19,132,9,10
1620,53567,0,0,deny,66,66,0,1,0,1,0
25061,53,25061,53,allow,214,82,132,2,32,1,1
55849,53,21168,53,allow,190,97,93,2,31,1,1
2890,53,28510,53,allow,78,78,0,1,30,1,0
59271,445,0,0,drop,70,70,0,1,0,1,0
44956,443,44956,443,allow,5220,1973,3247,22,38,13,9
58725,443,25110,443,allow,9279,5062,4217,56,259,25,31
46774,51050,0,0,deny,62,62,0,1,0,1,0
49864,53,25609,53,allow,186,95,91,2,31,1,1
58638,5900,0,0,deny,62,62,0,1,0,1,0
64751,53,58884,53,allow,178,94,84,2,31,1,1
56559,53,15416,53,allow,731,85,646,2,30,1,1
49840,443,49840,443,allow,4645,1738,2907,19,30,11,8
54745,445,0,0,drop,70,70,0,1,0,1,0
49619,80,12609,80,allow,318,192,126,6,42,4,2
24208,53,24208,53,allow,231,88,143,2,32,1,1
53105,53,53105,53,allow,216,90,126,2,30,1,1
62499,445,0,0,drop,70,70,0,1,0,1,0
14696,42707,0,0,deny,62,62,0,1,0,1,0
54820,445,0,0,drop,70,70,0,1,0,1,0
55662,53,45972,53,allow,212,102,110,2,30,1,1
58382,50584,0,0,deny,146,146,0,1,0,1,0
1903,43890,0,0,deny,66,66,0,1,0,1,0
56835,53,56114,53,allow,177,94,83,2,29,1,1
45816,443,14384,443,allow,21950,3632,18318,46,140,20,26
51750,54567,46467,54567,allow,70,70,0,1,5,1,0
56448,53,33079,53,allow,200,102,98,2,30,1,1
56967,443,1130,443,allow,9222,3148,6074,26,91,14,12
57202,53,47171,53,allow,184,94,90,2,30,1,1
64766,53,47744,53,allow,214,110,104,2,29,1,1
59165,53,3627,53,allow,320,94,226,2,30,1,1
59440,445,0,0,drop,70,70,0,1,0,1,0
51164,443,28609,443,allow,5040,2743,2297,34,185,18,16
57622,7000,57622,7000,allow,2343,856,1487,17,16,10,7
44847,9912,37796,9912,allow,502,150,352,2,1200,1,1
56161,80,10423,80,allow,2670,799,1871,13,46,8,5
58638,5900,0,0,deny,62,62,0,1,0,1,0
56696,445,0,0,drop,70,70,0,1,0,1,0
55421,57470,0,0,deny,74,74,0,1,0,1,0
54916,445,0,0,drop,70,70,0,1,0,1,0
63139,53,8265,53,allow,78,78,0,2,31,2,0
50970,80,61956,80,allow,11340,3061,8279,31,115,12,19
52319,445,0,0,drop,70,70,0,1,0,1,0
53772,14132,16590,14132,allow,70,70,0,2,8,2,0
51221,51413,63036,51413,allow,459,149,310,2,1200,1,1
51110,80,59490,80,allow,1524,1028,496,10,20,7,3
49640,443,44264,443,allow,12619,3258,9361,33,47,19,14
41156,53,41156,53,allow,216,82,134,2,31,1,1
53529,445,0,0,drop,70,70,0,1,0,1,0
58691,445,0,0,drop,66,66,0,1,0,1,0
33886,65504,0,0,deny,162,162,0,1,0,1,0
65174,53,23443,53,allow,214,110,104,2,30,1,1
43260,41615,0,0,deny,145,145,0,1,0,1,0
53818,445,0,0,drop,66,66,0,1,0,1,0
65192,53,25403,53,allow,249,102,147,2,30,1,1
51406,443,38367,443,allow,8186,2146,6040,29,33,16,13
60443,50284,54263,50284,allow,164,70,94,2,5,1,1
56426,53,37263,53,allow,184,94,90,2,31,1,1
51880,445,0,0,drop,70,70,0,1,0,1,0
49420,53,61159,53,allow,183,94,89,2,30,1,1
53104,445,0,0,drop,70,70,0,1,0,1,0
57768,37965,0,0,deny,66,66,0,1,0,1,0
1384,44847,0,0,deny,66,66,0,1,0,1,0
52138,445,0,0,drop,66,66,0,1,0,1,0
56341,443,63475,443,allow,8325,1483,6842,24,47,13,11
56747,445,0,0,drop,70,70,0,1,0,1,0
63952,53,35871,53,allow,289,102,187,2,30,1,1
0,0,0,0,deny,98,98,0,1,0,1,0
51999,445,0,0,drop,70,70,0,1,0,1,0
53397,445,0,0,drop,66,66,0,1,0,1,0
27005,27020,41783,27020,allow,898,126,772,2,30,1,1
65270,53,38040,53,allow,226,110,116,2,30,1,1
22904,56205,0,0,deny,62,62,0,1,0,1,0
58638,5900,0,0,deny,62,62,0,1,0,1,0
57326,53,9216,53,allow,180,94,86,2,35,1,1
61546,443,4493,443,allow,208,60,148,4,13,2,2
64065,53,29677,53,allow,270,94,176,2,30,1,1
53759,443,57982,443,allow,499,425,74,4,0,3,1
54807,53,14408,53,allow,206,86,120,2,30,1,1
52046,59791,21148,59791,allow,70,70,0,1,4,1,0
62744,445,0,0,drop,66,66,0,1,0,1,0
51015,64147,0,0,deny,62,62,0,1,0,1,0
50376,443,64568,443,allow,7738,879,6859,19,27,10,9
34990,80,31222,80,allow,350,210,140,6,28,4,2
43260,41615,0,0,deny,145,145,0,1,0,1,0
49381,53,1330,53,allow,209,110,99,2,30,1,1
50405,443,58184,443,allow,612,280,332,10,26,5,5
65126,53,60546,53,allow,718,94,624,2,30,1,1
56658,53,42222,53,allow,177,94,83,2,29,1,1
64899,53,42372,53,allow,767,102,665,2,29,1,1
65076,53,51472,53,allow,215,94,121,2,29,1,1
64122,53,64122,53,allow,220,90,130,2,30,1,1
63934,53,38044,53,allow,209,110,99,2,30,1,1
55404,445,0,0,drop,70,70,0,1,0,1,0
57442,66,49848,66,allow,70,70,0,2,8,2,0
43584,24748,0,0,deny,156,156,0,1,0,1,0
49629,26467,0,0,deny,62,62,0,1,0,1,0
52713,443,22767,443,allow,26235,2216,24019,39,318,17,22
47463,53,25330,53,allow,167,78,89,2,30,1,1
27005,27015,32214,27015,allow,878,126,752,2,30,1,1
50366,443,19959,443,allow,1755,986,769,13,25,8,5
10014,40026,21058,40026,allow,156,94,62,2,30,1,1
64237,51505,0,0,deny,62,62,0,1,0,1,0
52233,42673,65112,42673,allow,136,136,0,3,14,3,0
57365,53,10039,53,allow,780,104,676,2,31,1,1
49181,53,18919,53,allow,184,102,82,2,30,1,1
50360,37965,0,0,deny,66,66,0,1,0,1,0
54967,53,27983,53,allow,178,94,84,2,30,1,1
61304,443,62811,443,allow,8594,1042,7552,16,120,7,9
53820,7488,11201,7488,allow,70,70,0,2,8,2,0
58638,5900,0,0,deny,62,62,0,1,0,1,0
64205,53,1901,53,allow,178,94,84,2,30,1,1
64890,445,0,0,drop,66,66,0,1,0,1,0
55634,58846,18331,58846,allow,70,70,0,2,8,2,0
58638,5900,0,0,deny,62,62,0,1,0,1,0
37075,80,46978,80,allow,1678,1364,314,10,15,5,5
53681,31466,20007,31466,allow,70,70,0,1,5,1,0
52470,443,33189,443,allow,7915,1213,6702,23,50,12,11
45313,64147,0,0,deny,62,62,0,1,0,1,0
48735,443,54377,443,allow,77050,5353,71697,113,95,46,67
50106,30317,0,0,deny,66,66,0,1,0,1,0
65328,53,23014,53,allow,179,94,85,2,30,1,1
62234,445,0,0,drop,66,66,0,1,0,1,0
44849,46478,0,0,deny,74,74,0,1,0,1,0
56145,445,0,0,drop,70,70,0,1,0,1,0
64898,53,23347,53,allow,487,201,286,6,37,3,3
56614,80,65163,80,allow,234,234,0,4,11,4,0
65398,53,61803,53,allow,212,108,104,2,30,1,1
54998,53,51168,53,allow,195,102,93,2,30,1,1
55855,443,32782,443,allow,11485,3525,7960,32,33,18,14
65492,443,42698,443,allow,92573,4519,88054,105,16,39,66
54911,445,0,0,drop,70,70,0,1,0,1,0
49787,53,40556,53,allow,258,110,148,2,29,1,1
65124,53,4615,53,allow,353,118,235,2,30,1,1
53740,445,0,0,drop,70,70,0,1,0,1,0
55597,7485,34248,7485,allow,70,70,0,1,5,1,0
58638,5900,0,0,deny,62,62,0,1,0,1,0
49935,80,29909,80,allow,1130,613,517,11,15,6,5
54488,445,0,0,drop,70,70,0,1,0,1,0
51957,443,52201,443,allow,3516,1732,1784,34,42,19,15
3497,53,3497,53,allow,222,90,132,2,30,1,1
52105,1024,36023,1024,allow,70,70,0,2,7,2,0
55117,445,0,0,drop,70,70,0,1,0,1,0
62273,50584,0,0,deny,66,66,0,1,0,1,0
55067,443,14245,443,allow,1146,360,786,20,75,7,13
44960,80,44960,80,allow,4372,2093,2279,16,19,10,6
64847,22114,0,0,deny,66,66,0,1,0,1,0
49760,80,49760,80,allow,613303,16858,596445,666,143,251,415
47814,51505,0,0,deny,66,66,0,1,0,1,0
63786,25174,0,0,deny,66,66,0,1,0,1,0
36502,53,33412,53,allow,168,78,90,2,30,1,1
56492,53,4383,53,allow,212,102,110,2,30,1,1
8282,40200,5762,40200,allow,133,64,69,3,30,2,1
49182,21247,0,0,deny,62,62,0,1,0,1,0
64684,53,15819,53,allow,184,94,90,2,31,1,1
62088,56205,0,0,deny,66,66,0,1,0,1,0
52252,46314,0,0,deny,62,62,0,1,0,1,0
34436,80,7684,80,allow,6260,696,5564,17,15,9,8
16387,20045,0,0,deny,60,60,0,1,0,1,0
42282,443,42282,443,allow,2052,1187,865,21,76,11,10
1057,57470,0,0,deny,62,62,0,1,0,1,0
56672,443,28399,443,allow,7888,1899,5989,20,15,11,9
55365,53,47603,53,allow,184,94,90,2,31,1,1
26906,22114,0,0,deny,62,62,0,1,0,1,0
56227,53,18236,53,allow,174,89,85,2,31,1,1
50354,53,23392,53,allow,209,110,99,2,30,1,1
61413,443,10754,443,allow,4933,771,4162,18,28,8,10
50662,443,44987,443,allow,3306,1714,1592,17,16,9,8
52110,445,0,0,drop,70,70,0,1,0,1,0
43394,53,50886,53,allow,168,78,90,2,31,1,1
51490,50432,0,0,deny,100,100,0,1,0,1,0
49608,53,10158,53,allow,170,87,83,2,31,1,1
49183,53,29477,53,allow,209,110,99,2,30,1,1
59141,445,0,0,drop,66,66,0,1,0,1,0
58381,57470,0,0,deny,66,66,0,1,0,1,0
53960,30041,0,0,deny,66,66,0,1,0,1,0
62736,80,60766,80,allow,1516,481,1035,11,15,6,5
59319,53,47365,53,allow,285,106,179,2,31,1,1
49984,53,41486,53,allow,172,88,84,2,30,1,1
49871,443,47130,443,allow,615040,25597,589443,704,54,245,459
34351,53,57036,53,allow,202,83,119,2,31,1,1
49917,53,46665,53,allow,168,78,90,2,29,1,1
49786,443,10389,443,allow,8941,1816,7125,27,15,15,12
50354,445,0,0,drop,66,66,0,1,0,1,0
51674,51505,0,0,deny,66,66,0,1,0,1,0
56480,53,53765,53,allow,755,94,661,2,31,1,1
55042,80,32886,80,allow,306,180,126,6,34,4,2
54792,443,48996,443,allow,9515,2231,7284,25,22,14,11
51038,445,0,0,drop,70,70,0,1,0,1,0
64150,22114,0,0,deny,66,66,0,1,0,1,0
59532,445,0,0,drop,66,66,0,1,0,1,0
56322,53,2088,53,allow,209,110,99,2,30,1,1
50400,443,40237,443,allow,316,136,180,6,6,3,3
52717,445,0,0,drop,70,70,0,1,0,1,0
51458,445,0,0,drop,70,70,0,1,0,1,0
1536,48817,0,0,deny,62,62,0,1,0,1,0
52094,443,12498,443,allow,2960,1982,978,15,16,9,6
57917,44847,0,0,deny,66,66,0,1,0,1,0
49947,80,44031,80,allow,362232,10443,351789,387,15,147,240
35052,80,38624,80,allow,350,210,140,6,30,4,2
58638,5900,0,0,deny,62,62,0,1,0,1,0
49936,445,0,0,drop,70,70,0,1,0,1,0
58239,80,32964,80,allow,2444,2444,0,3,191,3,0
61246,445,0,0,drop,66,66,0,1,0,1,0
65506,443,5450,443,allow,92243,4519,87724,105,16,39,66
49456,53,22820,53,allow,308,101,207,4,32,2,2
49650,53,11402,53,allow,216,110,106,2,30,1,1
50798,36237,0,0,deny,146,146,0,1,0,1,0
0,0,0,0,allow,320,320,0,5,0,5,0
65285,44847,0,0,deny,62,62,0,1,0,1,0
1025,51221,0,0,deny,62,62,0,1,0,1,0
54924,443,37000,443,allow,62,62,0,1,4,1,0
52431,64147,0,0,deny,62,62,0,1,0,1,0
49946,80,45099,80,allow,31517,1203,30314,38,15,15,23
61190,21247,0,0,deny,66,66,0,1,0,1,0
56326,53,34552,53,allow,177,94,83,2,30,1,1
57915,443,51000,443,allow,4103,2950,1153,26,131,16,10
64361,53,3934,53,allow,194,94,100,2,30,1,1
57768,37965,0,0,deny,62,62,0,1,0,1,0
58638,5900,0,0,deny,62,62,0,1,0,1,0
51987,23136,59906,23136,allow,70,70,0,2,8,2,0
65246,53,13640,53,allow,767,102,665,2,30,1,1
55385,445,0,0,drop,70,70,0,1,0,1,0
51120,80,28128,80,allow,366,240,126,7,21,5,2
59878,53,26296,53,allow,391,102,289,2,29,1,1
55490,80,37170,80,allow,186387,10616,175771,243,33,116,127
53013,80,53013,80,allow,258732,4788,253944,268,25,71,197
51397,445,0,0,drop,66,66,0,1,0,1,0
40781,443,27911,443,allow,362,302,60,2,5,1,1
56137,53,13627,53,allow,198,101,97,2,30,1,1
64515,53,64413,53,allow,231,86,145,2,30,1,1
36908,26467,0,0,deny,62,62,0,1,0,1,0
42310,443,52115,443,allow,6673,2151,4522,27,125,13,14
25565,62979,0,0,deny,60,60,0,1,0,1,0
64935,53,11961,53,allow,186,95,91,2,31,1,1
58835,443,42835,443,allow,5166,700,4466,16,15,7,9
60113,22114,0,0,deny,66,66,0,1,0,1,0
39674,443,32592,443,allow,2828,1800,1028,27,184,15,12
6882,25021,51756,25021,allow,509,150,359,2,1200,1,1
48706,23393,0,0,deny,60,60,0,1,0,1,0
53866,8999,60577,8999,allow,372,186,186,6,15,3,3
63030,2222,0,0,deny,66,66,0,1,0,1,0
52120,42751,45034,42751,allow,70,70,0,1,5,1,0
49558,53,18984,53,allow,177,94,83,2,30,1,1
60797,445,0,0,drop,70,70,0,1,0,1,0
60037,443,12655,443,allow,6194,1289,4905,23,66,12,11
60666,445,0,0,drop,70,70,0,1,0,1,0
55144,443,25818,443,allow,6918,2826,4092,26,21,16,10
59043,35440,0,0,deny,66,66,0,1,0,1,0
21420,44847,0,0,deny,66,66,0,1,0,1,0
55830,53,50350,53,allow,166,86,80,2,30,1,1
51892,46647,6843,46647,allow,70,70,0,1,5,1,0
63910,53,63969,53,allow,178,75,103,2,30,1,1
29159,39004,0,0,deny,62,62,0,1,0,1,0
1938,53,25817,53,allow,210,78,132,2,30,1,1
52113,443,33178,443,allow,17710,1892,15818,37,24,17,20
51554,443,48017,443,allow,4263,671,3592,14,75,8,6
29022,23,0,0,deny,60,60,0,1,0,1,0
53972,59089,65256,59089,allow,70,70,0,2,7,2,0
41541,25174,0,0,deny,66,66,0,1,0,1,0
60867,443,29499,443,allow,3072,2174,898,14,317,8,6
53194,35440,0,0,deny,66,66,0,1,0,1,0
56487,53,32287,53,allow,194,102,92,2,30,1,1
56592,53,24895,53,allow,200,102,98,2,30,1,1
49168,53,56952,53,allow,196,102,94,2,30,1,1
53761,123,54980,123,allow,184,94,90,2,30,1,1
49606,445,0,0,drop,66,66,0,1,0,1,0
51526,4545,51526,4545,allow,156,156,0,3,8,3,0
60535,80,60535,80,allow,318,120,198,6,25,3,3
56579,53,36844,53,allow,288,94,194,2,30,1,1
55615,13826,16730,13826,allow,70,70,0,1,5,1,0
51963,22114,0,0,deny,66,66,0,1,0,1,0
53199,443,19271,443,allow,1582,965,617,15,18,7,8
63888,25174,0,0,deny,66,66,0,1,0,1,0
54366,445,0,0,drop,70,70,0,1,0,1,0
59105,443,52375,443,allow,8742,3785,4957,21,16,12,9
59937,37965,0,0,deny,66,66,0,1,0,1,0
53127,443,49935,443,allow,68982,15774,53208,113,45,42,71
50100,445,0,0,drop,70,70,0,1,0,1,0
64441,445,0,0,drop,70,70,0,1,0,1,0
50543,445,0,0,drop,66,66,0,1,0,1,0
56782,49135,47020,49135,allow,70,70,0,2,8,2,0
49220,2710,38165,2710,allow,70,70,0,1,5,1,0
63867,64147,0,0,deny,62,62,0,1,0,1,0
50269,443,37644,443,allow,8272,2455,5817,29,391,10,19
55276,53,58176,53,allow,177,94,83,2,30,1,1
52143,37807,0,0,deny,66,66,0,1,0,1,0
57204,53,58502,53,allow,182,93,89,2,30,1,1
49729,443,33717,443,allow,8322,2585,5737,23,16,12,11
56288,53,18039,53,allow,210,110,100,2,30,1,1
13062,52752,0,0,deny,66,66,0,1,0,1,0
53979,26308,29256,26308,allow,70,70,0,1,4,1,0
52432,50265,0,0,deny,66,66,0,1,0,1,0
41744,37965,0,0,deny,62,62,0,1,0,1,0
52711,37965,0,0,deny,62,62,0,1,0,1,0
52200,445,0,0,drop,70,70,0,1,0,1,0
59502,445,0,0,drop,70,70,0,1,0,1,0
55213,53,60229,53,allow,238,94,144,2,30,1,1
64378,53,28947,53,allow,273,94,179,2,30,1,1
61491,445,0,0,drop,66,66,0,1,0,1,0
50984,445,0,0,drop,66,66,0,1,0,1,0
52462,445,0,0,drop,70,70,0,1,0,1,0
64146,53,41885,53,allow,194,99,95,2,31,1,1
55865,53,22117,53,allow,184,94,90,2,30,1,1
63276,445,0,0,drop,70,70,0,1,0,1,0
65498,443,2400,443,allow,92290,4799,87491,107,16,43,64
60206,445,0,0,drop,70,70,0,1,0,1,0
57027,53,59688,53,allow,177,94,83,2,31,1,1
64525,53,61457,53,allow,199,102,97,2,30,1,1
64840,53,31006,53,allow,186,95,91,2,31,1,1
37587,443,50576,443,allow,499,425,74,4,0,3,1
10028,25604,0,0,deny,62,62,0,1,0,1,0
55513,53,1888,53,allow,184,94,90,2,30,1,1
50404,8080,50404,8080,allow,11938,4533,7405,33,98,20,13
58228,445,0,0,drop,66,66,0,1,0,1,0
51586,445,0,0,drop,66,66,0,1,0,1,0
55889,53,7976,53,allow,168,86,82,2,30,1,1
9304,443,28860,443,allow,3922,552,3370,16,16,8,8
56869,17637,0,0,deny,66,66,0,1,0,1,0
8160,80,8160,80,allow,1670,1044,626,15,84,8,7
8229,22114,0,0,deny,66,66,0,1,0,1,0
49257,53,41185,53,allow,166,86,80,2,30,1,1
50675,80,44462,80,allow,1658,1247,411,8,15,5,3
57299,443,9312,443,allow,23282,4482,18800,67,17,35,32
49996,53,6579,53,allow,183,94,89,2,30,1,1
56640,80,54626,80,allow,234,234,0,4,11,4,0
41840,50584,0,0,deny,66,66,0,1,0,1,0
64680,53,32256,53,allow,768,99,669,2,30,1,1
57734,445,0,0,drop,70,70,0,1,0,1,0
49913,443,1275,443,allow,4275,2222,2053,24,15,14,10
50933,443,10395,443,allow,10546,2453,8093,28,15,16,12
65280,445,0,0,drop,66,66,0,1,0,1,0
64712,445,0,0,drop,70,70,0,1,0,1,0
55534,53,23781,53,allow,168,86,82,2,30,1,1
55784,445,0,0,drop,70,70,0,1,0,1,0
50552,53,61704,53,allow,757,102,655,2,30,1,1
55582,445,0,0,drop,70,70,0,1,0,1,0
51083,445,0,0,drop,70,70,0,1,0,1,0
6224,37965,0,0,deny,62,62,0,1,0,1,0
49203,51050,0,0,deny,62,62,0,1,0,1,0
49296,53,29013,53,allow,186,95,91,2,31,1,1
62760,445,0,0,drop,66,66,0,1,0,1,0
57730,445,0,0,drop,70,70,0,1,0,1,0
52333,443,52333,443,allow,960,539,421,9,52,5,4
13413,44847,0,0,deny,66,66,0,1,0,1,0
53436,443,59367,443,allow,7941,2678,5263,25,122,12,13
56631,443,17729,443,allow,7889,1900,5989,20,16,11,9
64845,445,0,0,drop,70,70,0,1,0,1,0
59155,445,0,0,drop,66,66,0,1,0,1,0
55037,443,21745,443,allow,2639,258,2381,9,120,4,5
26081,53,34120,53,allow,75510,75228,282,904,90,902,2
57591,53,13897,53,allow,165,78,87,2,31,1,1
52975,23718,0,0,deny,66,66,0,1,0,1,0
61585,445,0,0,drop,70,70,0,1,0,1,0
60812,445,0,0,drop,70,70,0,1,0,1,0
61961,11392,0,0,deny,66,66,0,1,0,1,0
46600,443,0,0,deny,1097,1097,0,1,0,1,0
27419,23,0,0,deny,60,60,0,1,0,1,0
1485,53,1485,53,allow,194,87,107,2,30,1,1
56627,443,41594,443,allow,4499,947,3552,14,25,8,6
31691,50584,0,0,deny,62,62,0,1,0,1,0
57184,53,36086,53,allow,272,94,178,2,29,1,1
26448,41864,0,0,deny,145,145,0,1,0,1,0
51634,445,0,0,drop,66,66,0,1,0,1,0
50316,80,27928,80,allow,1677,862,815,10,15,5,5
61968,445,0,0,drop,70,70,0,1,0,1,0
49990,53,60528,53,allow,198,102,96,2,30,1,1
56511,53,55404,53,allow,200,102,98,2,30,1,1
61227,445,0,0,drop,70,70,0,1,0,1,0
62243,445,0,0,drop,70,70,0,1,0,1,0
53915,1026,61852,1026,allow,70,70,0,1,5,1,0
56243,53,64458,53,allow,762,101,661,2,30,1,1
52744,443,47091,443,allow,14838,2048,12790,32,25,18,14
65365,53,21509,53,allow,178,94,84,2,29,1,1
65134,445,0,0,drop,70,70,0,1,0,1,0
55144,53,47771,53,allow,209,102,107,2,30,1,1
56213,53,25430,53,allow,168,78,90,2,30,1,1
443,18177,0,0,deny,66,66,0,1,0,1,0
56972,53,60729,53,allow,301,126,175,2,30,1,1
5588,5588,0,0,allow,3562,1936,1626,48,192,24,24
58638,5900,0,0,deny,62,62,0,1,0,1,0
22784,9571,0,0,deny,62,62,0,1,0,1,0
53750,27352,21637,27352,allow,70,70,0,2,8,2,0
31956,53,16501,53,allow,268,94,174,2,30,1,1
6416,22114,0,0,deny,62,62,0,1,0,1,0
64789,53,51641,53,allow,199,102,97,2,30,1,1
43076,23,0,0,deny,60,60,0,1,0,1,0
56714,443,11426,443,allow,579769,15036,564733,578,61,199,379
53706,59208,33732,59208,allow,258,70,188,4,8,2,2
19473,32332,63968,32332,allow,481,150,331,2,1200,1,1
65426,53,23528,53,allow,706,195,511,6,52,3,3
25085,30188,0,0,deny,62,62,0,1,0,1,0
49749,445,0,0,drop,70,70,0,1,0,1,0
21750,39004,0,0,deny,66,66,0,1,0,1,0
56892,53,32986,53,allow,199,102,97,2,31,1,1
3717,25174,0,0,deny,62,62,0,1,0,1,0
46679,64147,0,0,deny,62,62,0,1,0,1,0
57603,80,57603,80,allow,4373,2985,1388,21,37,11,10
60480,57470,0,0,deny,62,62,0,1,0,1,0
32806,53,32806,53,allow,194,87,107,2,31,1,1
56704,53,49275,53,allow,177,94,83,2,31,1,1
43657,50011,0,0,deny,62,62,0,1,0,1,0
56832,445,0,0,drop,70,70,0,1,0,1,0
63723,445,0,0,drop,70,70,0,1,0,1,0
21322,25174,0,0,deny,62,62,0,1,0,1,0
43747,22114,0,0,deny,66,66,0,1,0,1,0
50905,445,0,0,drop,70,70,0,1,0,1,0
61699,443,44016,443,allow,16358,3103,13255,39,19,19,20
64567,53,64760,53,allow,193,102,91,2,30,1,1
64117,53,35902,53,allow,350,94,256,2,29,1,1
56845,443,17798,443,allow,16207,6355,9852,84,195,43,41
60707,80,12418,80,allow,144,78,66,2,5,1,1
44933,26467,0,0,deny,62,62,0,1,0,1,0
54835,443,59753,443,allow,678,280,398,11,26,5,6
57134,53,41374,53,allow,195,102,93,2,30,1,1
60868,445,0,0,drop,70,70,0,1,0,1,0
57035,80,15633,80,allow,953,524,429,11,256,6,5
58638,5900,0,0,deny,62,62,0,1,0,1,0
62075,445,0,0,drop,70,70,0,1,0,1,0
59813,53,59813,53,allow,228,97,131,2,30,1,1
62818,445,0,0,drop,66,66,0,1,0,1,0
49514,80,16033,80,allow,1352,832,520,12,38,7,5
49628,35440,0,0,deny,66,66,0,1,0,1,0
54887,443,19441,443,allow,4364,2141,2223,15,137,7,8
49621,53,59180,53,allow,287,93,194,4,56,2,2
55201,22114,0,0,deny,62,62,0,1,0,1,0
38508,443,38508,443,allow,279067,22871,256196,327,90,145,182
58638,5900,0,0,deny,62,62,0,1,0,1,0
51833,445,0,0,drop,66,66,0,1,0,1,0
57416,53,37012,53,allow,771,101,670,2,31,1,1
1024,25174,0,0,deny,62,62,0,1,0,1,0
57123,53,38680,53,allow,811,94,717,2,30,1,1
49981,53,37329,53,allow,438,180,258,6,30,3,3
51846,80,21384,80,allow,366,240,126,7,31,5,2
8168,80,8168,80,allow,282487,10736,271751,315,52,124,191
55037,443,53217,443,allow,13372,3722,9650,37,47,21,16
51865,14732,26909,14732,allow,70,70,0,2,7,2,0
42469,80,53240,80,allow,2169,1419,750,10,15,6,4
57421,80,60577,80,allow,4507,2978,1529,13,15,6,7
56911,53,22477,53,allow,211,78,133,2,30,1,1
58093,445,0,0,drop,70,70,0,1,0,1,0
63888,57470,0,0,deny,62,62,0,1,0,1,0
49202,31719,45347,31719,allow,70,70,0,2,8,2,0
49196,53,18490,53,allow,230,91,139,3,47,2,1
61135,445,0,0,drop,70,70,0,1,0,1,0
50250,53,19188,53,allow,172,88,84,2,30,1,1
63365,445,0,0,drop,70,70,0,1,0,1,0
51118,80,35500,80,allow,366,240,126,7,21,5,2
43260,41615,0,0,deny,145,145,0,1,0,1,0
49229,53,37715,53,allow,243,110,133,2,29,1,1
63898,13205,50081,13205,allow,70,70,0,1,4,1,0
59597,445,0,0,drop,70,70,0,1,0,1,0
16387,20045,0,0,deny,60,60,0,1,0,1,0
51410,443,1294,443,allow,619870,220857,399013,1045,123,531,514
49661,445,0,0,drop,70,70,0,1,0,1,0
50864,445,0,0,drop,66,66,0,1,0,1,0
50902,445,0,0,drop,70,70,0,1,0,1,0
44147,64147,0,0,deny,62,62,0,1,0,1,0
59861,445,0,0,drop,70,70,0,1,0,1,0
36339,50584,0,0,deny,146,146,0,1,0,1,0
46980,443,8668,443,allow,7633,5620,2013,31,60,19,12
55145,11392,0,0,deny,66,66,0,1,0,1,0
51837,37610,19513,37610,allow,316,136,180,6,5,3,3
52374,445,0,0,drop,70,70,0,1,0,1,0
55883,53,20281,53,allow,189,102,87,2,30,1,1
12830,25174,0,0,deny,62,62,0,1,0,1,0
49480,53,4215,53,allow,168,78,90,2,29,1,1
49509,443,14742,443,allow,17660,7465,10195,44,201,23,21
57470,29500,37295,29500,allow,2772,2772,0,43,2311,43,0
50849,80,37869,80,allow,1218354,26709,1191645,1128,133,332,796
41059,443,46382,443,allow,1248874,30382,1218492,1261,111,425,836
49785,443,35177,443,allow,7757,1949,5808,22,126,12,10
60339,7010,60339,7010,allow,3322,2027,1295,16,16,9,7
52650,445,0,0,drop,70,70,0,1,0,1,0
64472,53,59070,53,allow,183,94,89,2,31,1,1
28579,64147,0,0,deny,62,62,0,1,0,1,0
55504,445,0,0,drop,70,70,0,1,0,1,0
29145,8168,0,0,deny,62,62,0,1,0,1,0
55442,53,42681,53,allow,177,94,83,2,30,1,1
48817,6889,48817,6889,allow,480,149,331,2,1200,1,1
56523,443,42102,443,allow,5212,1037,4175,20,115,10,10
51958,443,6859,443,allow,9994,8270,1724,34,68,19,15
56360,53,50871,53,allow,814,110,704,2,30,1,1
26239,25174,0,0,deny,62,62,0,1,0,1,0
45473,53,13745,53,allow,168,78,90,2,31,1,1
57086,53,59882,53,allow,228,102,126,2,29,1,1
37564,443,37233,443,allow,1386,924,462,12,30,7,5
51244,21162,0,0,deny,100,100,0,1,0,1,0
56441,53,4935,53,allow,209,110,99,2,29,1,1
51346,51221,0,0,deny,74,74,0,1,0,1,0
55828,443,52104,443,allow,5278,1026,4252,20,15,11,9
51856,445,0,0,drop,70,70,0,1,0,1,0
61917,445,0,0,drop,70,70,0,1,0,1,0
60433,6881,42209,6881,allow,70,70,0,2,8,2,0
33498,5529,0,0,deny,145,145,0,1,0,1,0
63586,46824,0,0,deny,62,62,0,1,0,1,0
50211,1688,3994,1688,allow,70,70,0,1,4,1,0
56704,53,43778,53,allow,194,102,92,2,29,1,1
58485,445,0,0,drop,66,66,0,1,0,1,0
61666,443,28189,443,allow,1786,172,1614,7,120,3,4
56768,445,0,0,drop,70,70,0,1,0,1,0
62941,57470,0,0,deny,74,74,0,1,0,1,0
56504,53,9210,53,allow,195,94,101,2,30,1,1
64611,445,0,0,drop,70,70,0,1,0,1,0
50591,80,63944,80,allow,318,192,126,6,25,4,2
49172,445,0,0,drop,70,70,0,1,0,1,0
52680,445,0,0,drop,70,70,0,1,0,1,0
55246,31573,0,0,deny,66,66,0,1,0,1,0
52311,445,0,0,drop,70,70,0,1,0,1,0
27005,27015,19285,27015,allow,892,126,766,2,30,1,1
49713,53,3397,53,allow,198,102,96,2,30,1,1
49693,53,49502,53,allow,209,110,99,2,30,1,1
51950,445,0,0,drop,70,70,0,1,0,1,0
33227,53,32032,53,allow,177,86,91,2,30,1,1
49445,53,33858,53,allow,770,101,669,2,30,1,1
51706,25174,0,0,deny,66,66,0,1,0,1,0
57173,53,19613,53,allow,216,110,106,2,31,1,1
64000,53,28661,53,allow,241,102,139,2,30,1,1
50990,23884,0,0,deny,62,62,0,1,0,1,0
55217,443,55217,443,allow,3239,740,2499,15,40,8,7
36657,443,2188,443,allow,10985,3186,7799,29,204,14,15
38432,53,33848,53,allow,336,231,105,3,30,2,1
19245,64147,0,0,deny,66,66,0,1,0,1,0
64722,53,18980,53,allow,384,94,290,4,42,2,2
37927,50265,0,0,deny,66,66,0,1,0,1,0
55020,445,0,0,drop,70,70,0,1,0,1,0
13663,23,0,0,deny,60,60,0,1,0,1,0
47424,25174,0,0,deny,66,66,0,1,0,1,0
63884,445,0,0,drop,66,66,0,1,0,1,0
38891,80,9037,80,allow,5491,2690,2801,13,15,7,6
63133,445,0,0,drop,66,66,0,1,0,1,0
55642,445,0,0,drop,70,70,0,1,0,1,0
50823,443,51509,443,allow,6601,1120,5481,17,115,9,8
49511,80,32515,80,allow,1693924,34466,1659458,1627,230,522,1105
35570,443,53736,443,allow,3297,2327,970,22,37,11,11
53695,21965,20178,21965,allow,2044,1143,901,19,16,9,10
57470,9273,56118,9273,allow,491,150,341,2,1199,1,1
53669,59056,20109,59056,allow,70,70,0,1,5,1,0
6881,6881,0,0,deny,146,146,0,1,0,1,0
55836,443,16714,443,allow,3538,2015,1523,28,323,14,14
62443,445,0,0,drop,70,70,0,1,0,1,0
51985,38904,1159,38904,allow,70,70,0,1,5,1,0
34775,5900,0,0,deny,60,60,0,1,0,1,0
52650,44847,0,0,deny,66,66,0,1,0,1,0
51979,55803,3042,55803,allow,70,70,0,1,4,1,0
56532,53,51264,53,allow,186,95,91,2,31,1,1
56427,443,19838,443,allow,9901,1298,8603,19,79,10,9
12226,37965,0,0,deny,62,62,0,1,0,1,0
56958,53,59654,53,allow,816,102,714,2,30,1,1
63762,123,63358,123,allow,184,94,90,2,29,1,1
49429,53,2752,53,allow,194,102,92,2,30,1,1
64689,445,0,0,drop,70,70,0,1,0,1,0
52625,53,52625,53,allow,231,88,143,2,32,1,1
54187,445,0,0,drop,66,66,0,1,0,1,0
52970,445,0,0,drop,70,70,0,1,0,1,0
63937,53,33435,53,allow,183,94,89,2,30,1,1
65216,53,8359,53,allow,775,102,673,2,30,1,1
54388,445,0,0,drop,70,70,0,1,0,1,0
64190,445,0,0,drop,70,70,0,1,0,1,0
55044,53,10792,53,allow,196,102,94,2,31,1,1
54985,443,28045,443,allow,23913,3495,20418,50,48,24,26
50629,80,39121,80,allow,1658,1247,411,8,15,5,3
38065,443,63801,443,allow,911697,74083,837614,1247,343,459,788
64831,53,42481,53,allow,216,110,106,2,30,1,1
39537,8245,49028,8245,allow,280,214,66,2,30,1,1
50038,53,5932,53,allow,170,87,83,2,31,1,1
27988,40003,22369,40003,allow,148,86,62,2,30,1,1
16387,63752,0,0,deny,60,60,0,1,0,1,0
32983,51221,0,0,deny,66,66,0,1,0,1,0
57470,51413,13214,51413,allow,490,163,327,2,1200,1,1
63982,25174,0,0,deny,66,66,0,1,0,1,0
64605,53,39152,53,allow,182,93,89,2,30,1,1
9476,443,21369,443,allow,3999,905,3094,15,26,8,7
57020,36237,0,0,deny,62,62,0,1,0,1,0
48676,53389,0,0,deny,60,60,0,1,0,1,0
49211,80,44277,80,allow,8971,1094,7877,17,15,7,10
65251,53,53427,53,allow,199,102,97,2,30,1,1
51385,161,51385,161,allow,2315,979,1336,10,30,5,5
50246,445,0,0,drop,70,70,0,1,0,1,0
62872,50584,0,0,deny,66,66,0,1,0,1,0
64838,53,23821,53,allow,338,110,228,2,30,1,1
65285,445,0,0,drop,70,70,0,1,0,1,0
38057,443,24418,443,allow,9486,2668,6818,26,81,14,12
39983,80,29072,80,allow,1614,1300,314,10,16,5,5
15732,53,15732,53,allow,414,268,146,3,32,2,1
36712,53,0,0,allow,139,70,69,2,30,1,1
39543,7276,23316,7276,allow,1142,558,584,16,16,8,8
13166,57470,0,0,deny,62,62,0,1,0,1,0
61502,445,0,0,drop,66,66,0,1,0,1,0
55722,53,10365,53,allow,229,110,119,2,30,1,1
19858,64147,0,0,deny,62,62,0,1,0,1,0
52476,443,35367,443,allow,7787,3056,4731,19,87,10,9
65528,445,0,0,drop,70,70,0,1,0,1,0
57894,443,52904,443,allow,4544,1112,3432,21,176,12,9
49953,445,0,0,drop,66,66,0,1,0,1,0
55963,53,19959,53,allow,316,94,222,2,30,1,1
61167,443,24525,443,allow,27000,11646,15354,176,640,82,94
49164,25174,0,0,deny,62,62,0,1,0,1,0
60169,445,0,0,drop,70,70,0,1,0,1,0
58907,443,50091,443,allow,2976,1572,1404,17,17,9,8
61223,37965,0,0,deny,66,66,0,1,0,1,0
6882,43825,33329,43825,allow,200,111,89,2,1200,1,1
50905,443,13622,443,allow,124,64,60,2,15,1,1
65218,53,38514,53,allow,194,102,92,2,31,1,1
53366,445,0,0,drop,70,70,0,1,0,1,0
65166,445,0,0,drop,70,70,0,1,0,1,0
49869,80,37142,80,allow,2125,1041,1084,11,87,6,5
65363,53,30865,53,allow,178,91,87,2,31,1,1
51414,22,0,0,deny,60,60,0,1,0,1,0
18011,44847,0,0,deny,66,66,0,1,0,1,0
65341,53,36456,53,allow,200,102,98,2,31,1,1
53171,443,14871,443,allow,3220,2010,1210,20,19,10,10
56798,40759,43301,40759,allow,70,70,0,1,5,1,0
57065,53,34013,53,allow,272,110,162,2,29,1,1
55222,53,4063,53,allow,181,94,87,2,30,1,1
51399,443,28295,443,allow,642,582,60,2,5,1,1
59389,445,0,0,drop,70,70,0,1,0,1,0
64788,43890,0,0,deny,66,66,0,1,0,1,0
65194,53,10314,53,allow,178,91,87,2,31,1,1
10088,37807,0,0,deny,66,66,0,1,0,1,0
64514,53,1734,53,allow,209,102,107,2,30,1,1
52124,11296,48870,11296,allow,66,66,0,1,5,1,0
63416,445,0,0,drop,70,70,0,1,0,1,0
65300,53,37068,53,allow,190,97,93,2,31,1,1
61828,443,61828,443,allow,317388,25904,291484,338,200,128,210
19302,443,26733,443,allow,2227,1018,1209,17,15,8,9
9068,443,2083,443,allow,5045,2005,3040,14,119,7,7
30315,57470,0,0,deny,145,145,0,1,0,1,0
56474,53,9698,53,allow,209,110,99,2,29,1,1
43094,443,34606,443,allow,6443,1973,4470,19,16,11,8
23537,35253,0,0,deny,62,62,0,1,0,1,0
34366,443,43232,443,allow,1053,566,487,10,16,6,4
50295,445,0,0,drop,66,66,0,1,0,1,0
59398,443,65413,443,allow,3730,1956,1774,16,15,8,8
26900,27017,9336,27017,allow,422,164,258,6,30,3,3
60047,443,35596,443,allow,1350,689,661,14,44,8,6
60346,53,60346,53,allow,241,98,143,2,30,1,1
60015,443,28429,443,allow,6340,3788,2552,21,143,10,11
60108,443,32347,443,allow,9091,2988,6103,47,19,22,25
56424,53,21857,53,allow,177,94,83,2,30,1,1
42012,443,37519,443,allow,14271,2106,12165,42,227,17,25
58638,5900,0,0,deny,62,62,0,1,0,1,0
51239,443,46781,443,allow,9649,4615,5034,42,16,24,18
53867,60272,36955,60272,allow,70,70,0,1,5,1,0
41486,1433,0,0,deny,60,60,0,1,0,1,0
65015,22114,0,0,deny,62,62,0,1,0,1,0
64940,26467,0,0,deny,62,62,0,1,0,1,0
61437,445,0,0,drop,70,70,0,1,0,1,0
55968,53,21608,53,allow,243,94,149,2,30,1,1
52236,25174,0,0,deny,66,66,0,1,0,1,0
49242,53,51879,53,allow,183,94,89,2,30,1,1
7665,80,7665,80,allow,110567,7016,103551,135,46,60,75
54242,443,22470,443,allow,499,425,74,4,0,3,1
56560,53,3085,53,allow,199,102,97,2,30,1,1
58638,5900,0,0,deny,62,62,0,1,0,1,0
41833,443,22584,443,allow,50425,3972,46453,63,122,25,38
14433,443,47619,443,allow,2589,1443,1146,18,15,8,10
63033,53,19877,53,allow,304,86,218,2,30,1,1
55906,445,0,0,drop,70,70,0,1,0,1,0
58394,53,41554,53,allow,274,94,180,2,30,1,1
59186,445,0,0,drop,70,70,0,1,0,1,0
60075,41705,0,0,deny,66,66,0,1,0,1,0
51348,25174,0,0,deny,66,66,0,1,0,1,0
57098,53,51101,53,allow,229,94,135,2,30,1,1
59509,64147,0,0,deny,145,145,0,1,0,1,0
63999,53,43877,53,allow,186,95,91,2,30,1,1
50593,64147,0,0,deny,66,66,0,1,0,1,0
43584,24748,0,0,deny,156,156,0,1,0,1,0
13462,35440,0,0,deny,62,62,0,1,0,1,0
64199,445,0,0,drop,70,70,0,1,0,1,0
49514,39127,0,0,deny,162,162,0,1,0,1,0
50265,45682,34420,45682,allow,330,330,0,6,1200,6,0
50356,445,0,0,drop,66,66,0,1,0,1,0
53124,443,13902,443,allow,7459,2962,4497,24,47,14,10
65499,53,26043,53,allow,167,86,81,2,29,1,1
53244,53,53244,53,allow,217,82,135,2,32,1,1
13484,37965,0,0,deny,62,62,0,1,0,1,0
41764,53,7946,53,allow,168,78,90,2,29,1,1
50158,53,45524,53,allow,758,96,662,2,30,1,1
64751,445,0,0,drop,66,66,0,1,0,1,0
58226,52848,0,0,deny,62,62,0,1,0,1,0
49982,37965,0,0,deny,66,66,0,1,0,1,0
53227,64097,0,0,deny,66,66,0,1,0,1,0
60303,445,0,0,drop,70,70,0,1,0,1,0
50106,31573,0,0,deny,66,66,0,1,0,1,0
37035,443,37035,443,allow,4510,1603,2907,19,28,11,8
53194,443,63620,443,allow,1462,965,497,13,18,7,6
54492,445,0,0,drop,70,70,0,1,0,1,0
9748,21247,0,0,deny,66,66,0,1,0,1,0
52937,443,42865,443,allow,22218,12408,9810,66,115,33,33
53848,43725,33158,43725,allow,552,306,246,9,15,5,4
37715,53,37715,53,allow,235,90,145,2,32,1,1
51073,80,13586,80,allow,525373,237667,287706,1387,390,693,694
6881,58293,28909,58293,allow,228,118,110,2,1200,1,1
63015,445,0,0,drop,70,70,0,1,0,1,0
52430,22114,0,0,deny,62,62,0,1,0,1,0
63460,55160,0,0,deny,66,66,0,1,0,1,0
64748,53,6781,53,allow,183,94,89,2,30,1,1
62716,23,0,0,deny,60,60,0,1,0,1,0
54705,443,23468,443,allow,5411,851,4560,17,15,8,9
6247,51221,0,0,deny,78,78,0,1,0,1,0
51059,445,0,0,drop,66,66,0,1,0,1,0
51426,47563,0,0,deny,100,100,0,1,0,1,0
58305,18375,0,0,deny,62,62,0,1,0,1,0
49521,53,3193,53,allow,183,94,89,2,30,1,1
57470,47191,13630,47191,allow,528,528,0,9,1200,9,0
49023,5223,36604,5223,allow,139,139,0,1,5,1,0
27005,27018,3011,27018,allow,882,126,756,2,30,1,1
62111,35440,0,0,deny,66,66,0,1,0,1,0
55463,445,0,0,drop,70,70,0,1,0,1,0
59958,443,39480,443,allow,2303,1334,969,18,16,10,8
53651,47758,11315,47758,allow,70,70,0,1,5,1,0
56846,53,43478,53,allow,196,102,94,2,30,1,1
54174,445,0,0,drop,70,70,0,1,0,1,0
46904,443,22687,443,allow,1314,653,661,13,184,7,6
49316,445,0,0,drop,70,70,0,1,0,1,0
49567,5223,11151,5223,allow,9705,5123,4582,29,74,15,14
49512,53,53127,53,allow,190,97,93,2,31,1,1
55407,445,0,0,drop,70,70,0,1,0,1,0
50239,443,44236,443,allow,9418,2681,6737,39,256,18,21
58930,443,53896,443,allow,70,70,0,1,5,1,0
6886,55839,0,0,deny,139,139,0,1,0,1,0
57334,53,42427,53,allow,184,94,90,2,30,1,1
65374,53,40635,53,allow,376,102,274,4,47,2,2
33044,443,19147,443,allow,268582,23654,244928,341,190,128,213
60398,46776,0,0,deny,74,74,0,1,0,1,0
61745,443,5419,443,allow,8123,5308,2815,18,134,9,9
443,46382,0,0,deny,66,66,0,1,0,1,0
55668,445,0,0,drop,70,70,0,1,0,1,0
48808,443,13852,443,allow,8192,2071,6121,23,361,10,13
50613,80,39114,80,allow,85306,4735,80571,120,22,55,65
55093,445,0,0,drop,66,66,0,1,0,1,0
58778,445,0,0,drop,70,70,0,1,0,1,0
49514,443,49514,443,allow,234110,36300,197810,309,66,160,149
49740,443,61794,443,allow,7554,2281,5273,22,129,13,9
52569,445,0,0,drop,70,70,0,1,0,1,0
57027,445,0,0,drop,66,66,0,1,0,1,0
59991,445,0,0,drop,66,66,0,1,0,1,0
56086,443,37563,443,allow,7535,1003,6532,24,304,7,17
55502,445,0,0,drop,66,66,0,1,0,1,0
59563,30188,0,0,deny,66,66,0,1,0,1,0
41064,80,41064,80,allow,2118,1493,625,9,82,6,3
57139,53,51563,53,allow,166,86,80,2,30,1,1
54984,443,11572,443,allow,68519,3801,64718,93,31,40,53
62729,445,0,0,drop,66,66,0,1,0,1,0
62651,445,0,0,drop,70,70,0,1,0,1,0
56770,53,41386,53,allow,212,110,102,2,30,1,1
53899,45682,27773,45682,allow,70,70,0,2,7,2,0
65071,445,0,0,drop,66,66,0,1,0,1,0
55184,53,55740,53,allow,443,92,351,4,31,2,2
42722,56448,0,0,deny,74,74,0,1,0,1,0
57282,53,14101,53,allow,199,102,97,2,30,1,1
49540,50584,0,0,deny,66,66,0,1,0,1,0
60299,80,6795,80,allow,1557,778,779,11,144,6,5
56143,445,0,0,drop,66,66,0,1,0,1,0
35311,80,30298,80,allow,947,376,571,8,14,5,3
53783,443,19626,443,allow,499,425,74,4,0,3,1
60438,17148,53794,17148,allow,70,70,0,2,8,2,0
60485,22114,0,0,deny,66,66,0,1,0,1,0
52112,443,29903,443,allow,59796,4486,55310,92,48,45,47
63255,445,0,0,drop,66,66,0,1,0,1,0
57857,445,0,0,drop,70,70,0,1,0,1,0
52652,445,0,0,drop,66,66,0,1,0,1,0
32806,7275,35238,7275,allow,130,70,60,2,15,1,1
44361,443,44674,443,allow,424,210,214,7,132,4,3
57890,445,0,0,drop,66,66,0,1,0,1,0
64268,53,45536,53,allow,334,103,231,4,54,2,2
55316,445,0,0,drop,66,66,0,1,0,1,0
49559,443,1739,443,allow,3641,1047,2594,14,120,7,7
443,22323,0,0,deny,61,61,0,1,0,1,0
54048,25174,0,0,deny,66,66,0,1,0,1,0
56536,53,49265,53,allow,209,110,99,2,30,1,1
55310,53,16833,53,allow,180,94,86,2,30,1,1
7595,80,7595,80,allow,34707,1796,32911,45,45,20,25
53114,445,0,0,drop,66,66,0,1,0,1,0
52091,4789,61902,4789,allow,70,70,0,1,5,1,0
50561,80,19741,80,allow,318,192,126,6,26,4,2
63421,44847,0,0,deny,66,66,0,1,0,1,0
5234,28162,61929,28162,allow,449555,320,449235,719,50,6,713
2588,53,2588,53,allow,197,76,121,2,30,1,1
35154,60038,0,0,allow,66,66,0,1,91,1,0
59068,49813,0,0,deny,74,74,0,1,0,1,0
55132,53,34901,53,allow,889,404,485,10,30,5,5
28824,44847,0,0,deny,66,66,0,1,0,1,0
50135,50584,0,0,deny,62,62,0,1,0,1,0
9169,80,55933,80,allow,318,192,126,6,29,4,2
34150,443,7922,443,allow,12564,9272,3292,66,107,31,35
53942,445,0,0,drop,66,66,0,1,0,1,0
65200,53,35834,53,allow,290,102,188,2,30,1,1
60848,443,33330,443,allow,6513,1863,4650,28,255,15,13
1091,37965,0,0,deny,62,62,0,1,0,1,0
65511,443,62661,443,allow,430254,12640,417614,442,16,155,287
59570,443,54074,443,allow,6713,3052,3661,49,5974,15,34
0,0,0,0,deny,156,156,0,2,0,2,0
53250,443,16467,443,allow,70319,5815,64504,146,67,52,94
3478,61463,0,0,deny,1188,1188,0,1,0,1,0
0,0,0,0,deny,156,156,0,2,0,2,0
65370,53,23524,53,allow,193,102,91,2,30,1,1
57186,53,42967,53,allow,177,94,83,2,30,1,1
26921,57470,0,0,deny,62,62,0,1,0,1,0
63291,445,0,0,drop,70,70,0,1,0,1,0
65381,445,0,0,drop,70,70,0,1,0,1,0
64313,445,0,0,drop,70,70,0,1,0,1,0
25463,53,62402,53,allow,827,91,736,4,29,2,2
64217,53,23995,53,allow,193,102,91,2,30,1,1
58638,5900,0,0,deny,62,62,0,1,0,1,0
59433,53,26803,53,allow,218,78,140,2,29,1,1
49657,443,29231,443,allow,9039,2175,6864,32,20,17,15
55024,443,1691,443,allow,552073,14113,537960,536,31,176,360
57363,53,6725,53,allow,172,88,84,2,31,1,1
54498,443,44231,443,allow,8060,2001,6059,24,19,14,10
53987,445,0,0,drop,70,70,0,1,0,1,0
1025,50584,0,0,deny,62,62,0,1,0,1,0
59634,445,0,0,drop,70,70,0,1,0,1,0
64730,53,52714,53,allow,1152,86,1066,2,29,1,1
61995,445,0,0,drop,70,70,0,1,0,1,0
57063,53,6247,53,allow,193,102,91,2,29,1,1
57161,53,42229,53,allow,224,102,122,2,29,1,1
50436,443,10408,443,allow,18959,3307,15652,33,19,16,17
49717,53,48239,53,allow,444,96,348,4,44,2,2
49270,53,27956,53,allow,216,110,106,2,31,1,1
50421,53,19651,53,allow,762,98,664,2,30,1,1
56816,11392,0,0,deny,62,62,0,1,0,1,0
27005,27015,40148,27015,allow,886,126,760,2,31,1,1
3981,23117,0,0,deny,66,66,0,1,0,1,0
65313,53,6135,53,allow,193,102,91,2,30,1,1
55262,443,33483,443,allow,28633618,753499,27880119,30116,102,8846,21270
61030,53,15331,53,allow,167,78,89,2,30,1,1
59181,445,0,0,drop,70,70,0,1,0,1,0
53752,445,0,0,drop,66,66,0,1,0,1,0
55098,53,14805,53,allow,180,94,86,2,30,1,1
62464,443,10700,443,allow,4595,3120,1475,18,33,10,8
53547,445,0,0,drop,66,66,0,1,0,1,0
7222,57470,0,0,deny,62,62,0,1,0,1,0
1356,57470,0,0,deny,72,72,0,1,0,1,0
49418,27015,63355,27015,allow,244,78,166,2,30,1,1
65463,445,0,0,drop,70,70,0,1,0,1,0
1035,57470,0,0,deny,72,72,0,1,0,1,0
58500,445,0,0,drop,66,66,0,1,0,1,0
49927,445,0,0,drop,66,66,0,1,0,1,0
53260,443,22555,443,allow,23664,2213,21451,41,323,17,24
53918,443,16862,443,allow,499,425,74,4,0,3,1
27005,27016,56355,27016,allow,1646,126,1520,4,31,2,2
54140,445,0,0,drop,66,66,0,1,0,1,0
56395,53,34668,53,allow,199,102,97,2,29,1,1
61876,443,60944,443,allow,3776,1446,2330,20,153,9,11
47279,443,50478,443,allow,7948,1520,6428,21,16,13,8
55901,53,32764,53,allow,226,110,116,2,30,1,1
1924,80,29370,80,allow,214,140,74,4,15,3,1
57539,44847,0,0,deny,62,62,0,1,0,1,0
34275,443,58408,443,allow,4880,3216,1664,29,79,15,14
29746,53,29746,53,allow,235,90,145,2,32,1,1
58426,445,0,0,drop,66,66,0,1,0,1,0
49521,53,40316,53,allow,183,94,89,2,30,1,1
42971,3478,30766,3478,allow,312,140,172,4,30,2,2
56863,53,37391,53,allow,177,94,83,2,30,1,1
62369,445,0,0,drop,70,70,0,1,0,1,0
62694,445,0,0,drop,66,66,0,1,0,1,0
54995,443,42324,443,allow,13281,4753,8528,32,17,18,14
53527,45626,13998,45626,allow,70,70,0,1,5,1,0
14692,25174,0,0,deny,62,62,0,1,0,1,0
50387,443,3636,443,allow,2227,1018,1209,17,16,8,9
57309,53,11380,53,allow,194,99,95,2,30,1,1
55352,53,47404,53,allow,216,110,106,2,30,1,1
56768,10880,3397,10880,allow,70,70,0,1,5,1,0
63384,445,0,0,drop,70,70,0,1,0,1,0
56400,35440,0,0,deny,66,66,0,1,0,1,0
51509,24855,0,0,allow,66,66,0,1,90,1,0
48071,25174,0,0,deny,62,62,0,1,0,1,0
42034,28189,0,0,deny,145,145,0,1,0,1,0
57005,80,30107,80,allow,214,140,74,4,30,3,1
2904,44847,0,0,deny,78,78,0,1,0,1,0
57427,443,63478,443,allow,5337,1085,4252,14,76,8,6
50310,80,45251,80,allow,2958,1116,1842,15,83,8,7
64582,53,17757,53,allow,209,110,99,2,30,1,1
50286,443,30253,443,allow,10203,2365,7838,40,86,22,18
34424,53,34424,53,allow,235,90,145,2,33,1,1
56082,53,33966,53,allow,807,94,713,2,29,1,1
48962,161,0,0,allow,8507,3320,5187,28,30,14,14
65352,443,3902,443,allow,12690,1918,10772,39,195,19,20
59274,445,0,0,drop,66,66,0,1,0,1,0
29203,26467,0,0,deny,62,62,0,1,0,1,0
50385,445,0,0,drop,70,70,0,1,0,1,0
45602,443,17240,443,allow,4417,3084,1333,17,361,9,8
49724,53,13142,53,allow,183,94,89,2,30,1,1
55485,445,0,0,drop,70,70,0,1,0,1,0
44258,25,0,0,deny,74,74,0,1,0,1,0
11030,37965,0,0,deny,62,62,0,1,0,1,0
62618,445,0,0,drop,66,66,0,1,0,1,0
49925,80,49556,80,allow,1126,609,517,11,15,6,5
63901,445,0,0,drop,66,66,0,1,0,1,0
32551,51221,0,0,deny,66,66,0,1,0,1,0
32945,80,47829,80,allow,234,234,0,4,12,4,0
33640,53,0,0,allow,139,70,69,2,30,1,1
10348,25604,0,0,deny,66,66,0,1,0,1,0
1038,37965,0,0,deny,62,62,0,1,0,1,0
9326,443,61009,443,allow,3616,429,3187,11,15,6,5
18381,53,18381,53,allow,237,91,146,2,32,1,1
65270,3855,0,0,deny,78,78,0,1,0,1,0
57896,1,0,0,deny,100,100,0,1,0,1,0
56674,53,17434,53,allow,183,94,89,2,31,1,1
58638,5900,0,0,deny,62,62,0,1,0,1,0
35833,443,20943,443,allow,5524,1857,3667,27,3652,9,18
60298,443,32921,443,allow,9565,3317,6248,25,144,14,11
47200,443,56772,443,allow,11003,3821,7182,35,257,14,21
57720,445,0,0,drop,70,70,0,1,0,1,0
59887,445,0,0,drop,70,70,0,1,0,1,0
55621,445,0,0,drop,70,70,0,1,0,1,0
50358,80,31825,80,allow,318,192,126,6,28,4,2
49418,27017,63792,27017,allow,256,71,185,2,30,1,1
64589,445,0,0,drop,70,70,0,1,0,1,0
46713,53,46713,53,allow,217,87,130,2,31,1,1
59863,443,54710,443,allow,12809,7765,5044,95,84,55,40
50278,53,13442,53,allow,196,102,94,2,31,1,1
50690,443,9122,443,allow,152,86,66,2,4,1,1
51263,445,0,0,drop,66,66,0,1,0,1,0
64332,53,40499,53,allow,167,86,81,2,30,1,1
59406,445,0,0,drop,70,70,0,1,0,1,0
56223,53,26337,53,allow,177,94,83,2,30,1,1
33040,443,3946,443,allow,118,118,0,1,30,1,0
53257,37450,0,0,deny,62,62,0,1,0,1,0
49752,53,46099,53,allow,180,92,88,2,31,1,1
51892,46647,34851,46647,allow,70,70,0,2,8,2,0
60462,47821,9617,47821,allow,70,70,0,1,5,1,0
22659,53,22659,53,allow,247,98,149,2,32,1,1
50523,443,53596,443,allow,6676,1074,5602,22,84,12,10
49472,53,37751,53,allow,210,110,100,2,30,1,1
53463,29500,1810,29500,allow,877,577,300,10,143,5,5
21606,80,0,0,deny,60,60,0,1,0,1,0
54779,445,0,0,drop,70,70,0,1,0,1,0
59803,445,0,0,drop,66,66,0,1,0,1,0
58638,5900,0,0,deny,62,62,0,1,0,1,0
57771,445,0,0,drop,70,70,0,1,0,1,0
60018,64147,0,0,deny,62,62,0,1,0,1,0
56809,53,41798,53,allow,178,94,84,2,31,1,1
57007,5333,59200,5333,allow,7194101,1949033,5245068,50585,1008,24913,25672
51188,64147,0,0,deny,62,62,0,1,0,1,0
57395,53,57395,53,allow,208,82,126,2,30,1,1
55459,50584,0,0,deny,62,62,0,1,0,1,0
65237,445,0,0,drop,70,70,0,1,0,1,0
49475,53,49996,53,allow,243,110,133,2,30,1,1
64341,57470,0,0,deny,62,62,0,1,0,1,0
15503,8624,29745,8624,allow,491,150,341,2,1200,1,1
53875,43611,35716,43611,allow,70,70,0,2,8,2,0
50518,443,9409,443,allow,7117,1288,5829,22,84,12,10
56033,443,32455,443,allow,3250,1058,2192,13,136,6,7
52236,25174,0,0,deny,62,62,0,1,0,1,0
57406,53,8433,53,allow,194,102,92,2,31,1,1
55088,53,2549,53,allow,186,95,91,2,31,1,1
35657,48637,0,0,deny,62,62,0,1,0,1,0
63832,25174,0,0,deny,66,66,0,1,0,1,0
55656,53,44214,53,allow,214,110,104,2,30,1,1
25565,18855,0,0,deny,60,60,0,1,0,1,0
26531,37965,0,0,deny,62,62,0,1,0,1,0
45682,37965,0,0,deny,145,145,0,1,0,1,0
42379,443,33462,443,allow,1622,1137,485,11,26,7,4
40418,25174,0,0,deny,66,66,0,1,0,1,0
56163,53,47516,53,allow,265,85,180,4,41,2,2
65371,445,0,0,drop,66,66,0,1,0,1,0
59087,445,0,0,drop,70,70,0,1,0,1,0
5938,35070,0,0,allow,60,60,0,1,90,1,0
50419,80,4719,80,allow,350,350,0,1,120,1,0
3478,61463,0,0,deny,1162,1162,0,1,0,1,0
51205,443,62572,443,allow,8857,2827,6030,52,17,29,23
55889,53,50897,53,allow,199,102,97,2,29,1,1
55329,445,0,0,drop,70,70,0,1,0,1,0
19204,56448,0,0,deny,78,78,0,1,0,1,0
64266,53,53096,53,allow,1026,383,643,10,84,5,5
55981,80,6270,80,allow,130,70,60,2,15,1,1
50095,445,0,0,drop,70,70,0,1,0,1,0
64365,53,27467,53,allow,341,110,231,2,29,1,1
53599,445,0,0,drop,70,70,0,1,0,1,0
64275,53,47758,53,allow,192,90,102,2,31,1,1
443,46080,0,0,deny,66,66,0,1,0,1,0
64312,53,41455,53,allow,225,110,115,2,30,1,1
64406,50584,0,0,deny,62,62,0,1,0,1,0
56456,53,8981,53,allow,195,102,93,2,30,1,1
62623,443,47203,443,allow,5311,1546,3765,15,122,7,8
53967,54589,61471,54589,allow,70,70,0,1,5,1,0
56544,445,0,0,drop,70,70,0,1,0,1,0
27147,22114,0,0,deny,62,62,0,1,0,1,0
62806,445,0,0,drop,70,70,0,1,0,1,0
35849,30188,0,0,deny,62,62,0,1,0,1,0
42955,80,63046,80,allow,72023,4897,67126,97,115,46,51
50394,25174,0,0,deny,62,62,0,1,0,1,0
33809,80,12746,80,allow,1052,612,440,10,15,5,5
63205,443,63205,443,allow,9324,4240,5084,24,16,13,11
3478,61463,0,0,deny,503,503,0,1,0,1,0
46491,50584,0,0,deny,66,66,0,1,0,1,0
36838,443,43654,443,allow,9381,1457,7924,21,31,11,10
65018,53,37688,53,allow,152,78,74,2,30,1,1
55729,53,33239,53,allow,199,102,97,2,30,1,1
52830,22114,0,0,deny,62,62,0,1,0,1,0
34155,443,36605,443,allow,154,94,60,2,5,1,1
33911,53,0,0,allow,82,82,0,1,30,1,0
50025,53,43960,53,allow,536,120,416,4,59,2,2
6881,6881,0,0,deny,62,62,0,1,0,1,0
57979,443,3610,443,allow,7970957,82522,7888435,6370,179,1027,5343
59210,8168,0,0,deny,66,66,0,1,0,1,0
64882,53,2357,53,allow,176,90,86,2,30,1,1
54819,443,51937,443,allow,9035,1873,7162,28,124,14,14
55729,53,3509,53,allow,199,102,97,2,30,1,1
53561,35885,5770,35885,allow,70,70,0,1,5,1,0
65189,27216,23592,27216,allow,226,71,155,2,31,1,1
54234,80,54234,80,allow,2334,1575,759,11,148,6,5
53556,1024,53867,1024,allow,70,70,0,2,8,2,0
50837,445,0,0,drop,66,66,0,1,0,1,0
64202,53,3004,53,allow,316,89,227,4,50,2,2
65079,53,34794,53,allow,272,94,178,2,30,1,1
28176,35440,0,0,deny,146,146,0,1,0,1,0
61382,443,28176,443,allow,32082,12801,19281,62,150,25,37
58558,53,58236,53,allow,268,86,182,2,30,1,1
63772,35440,0,0,deny,66,66,0,1,0,1,0
49291,53,26536,53,allow,277,110,167,2,30,1,1
53937,28506,44986,28506,allow,492,306,186,8,15,5,3
58769,443,51640,443,allow,3923,2459,1464,17,17,8,9
59051,27520,0,0,deny,62,62,0,1,0,1,0
55567,445,0,0,drop,66,66,0,1,0,1,0
65209,445,0,0,drop,70,70,0,1,0,1,0
11992,443,11992,443,allow,12020,5977,6043,38,30,23,15
50054,445,0,0,drop,70,70,0,1,0,1,0
26651,25174,0,0,deny,146,146,0,1,0,1,0
8282,25916,26002,25916,allow,133,64,69,3,33,2,1
58638,5900,0,0,deny,62,62,0,1,0,1,0
49186,443,54954,443,allow,508520,13734,494786,527,18,192,335
55184,53,63377,53,allow,183,94,89,2,30,1,1
33305,54532,0,0,deny,60,60,0,1,0,1,0
27005,30007,41112,30007,allow,890,126,764,2,31,1,1
53287,445,0,0,drop,70,70,0,1,0,1,0
57173,53,39121,53,allow,168,78,90,2,30,1,1
54266,445,0,0,drop,66,66,0,1,0,1,0
65023,53,34897,53,allow,587,104,483,4,40,2,2
64947,53,23514,53,allow,275,96,179,4,41,2,2
50604,80,39550,80,allow,1658,1247,411,8,15,5,3
60400,443,24179,443,allow,7073,1556,5517,21,80,11,10
22924,25174,0,0,deny,146,146,0,1,0,1,0
52286,995,52286,995,allow,146,82,64,2,5,1,1
49204,445,0,0,drop,66,66,0,1,0,1,0
53886,445,0,0,drop,70,70,0,1,0,1,0
50012,445,0,0,drop,70,70,0,1,0,1,0
60739,40010,46673,40010,allow,316,136,180,6,6,3,3
60166,443,54772,443,allow,7639,2673,4966,36,255,17,19
50998,445,0,0,drop,66,66,0,1,0,1,0
54625,53,52244,53,allow,168,78,90,2,30,1,1
52139,445,0,0,drop,66,66,0,1,0,1,0
50788,48817,0,0,deny,62,62,0,1,0,1,0
60205,53,4372,53,allow,491,115,376,2,31,1,1
49223,443,17029,443,allow,14838,6995,7843,52,244,26,26
55047,443,3031,443,allow,7069,2512,4557,25,46,14,11
54499,445,0,0,drop,70,70,0,1,0,1,0
52000,80,36562,80,allow,416,210,206,7,26,4,3
55056,53,51122,53,allow,209,110,99,2,30,1,1
50022,53,19595,53,allow,182,94,88,2,30,1,1
58599,445,0,0,drop,66,66,0,1,0,1,0
54018,443,16505,443,allow,13330,3836,9494,53,255,29,24
49933,53,13874,53,allow,186,102,84,2,30,1,1
50582,53,45109,53,allow,216,110,106,2,30,1,1
56211,445,0,0,drop,70,70,0,1,0,1,0
56939,53,41233,53,allow,322,134,188,2,30,1,1
11859,64147,0,0,deny,62,62,0,1,0,1,0
57419,443,3080,443,allow,9224,2381,6843,29,19,14,15
64561,53,25485,53,allow,270,94,176,2,30,1,1
27005,27015,61503,27015,allow,868,126,742,3,31,2,1
7184,15503,0,0,deny,66,66,0,1,0,1,0
51622,53,52520,53,allow,260,86,174,2,30,1,1
56120,53,56120,53,allow,237,91,146,2,33,1,1
49612,80,44677,80,allow,378,192,186,7,41,4,3
45410,1,0,0,deny,62,62,0,1,0,1,0
52154,4635,63801,4635,allow,70,70,0,2,8,2,0
56846,26665,12553,26665,allow,70,70,0,2,8,2,0
51334,445,0,0,drop,70,70,0,1,0,1,0
45964,55559,0,0,deny,60,60,0,1,0,1,0
17101,25174,0,0,deny,66,66,0,1,0,1,0
63458,445,0,0,drop,70,70,0,1,0,1,0
56887,53,15975,53,allow,170,87,83,3,56,2,1
0,0,0,0,deny,98,98,0,1,0,1,0
43661,443,21697,443,allow,11255,7612,3643,36,248,19,17
63532,445,0,0,drop,70,70,0,1,0,1,0
61232,443,38058,443,allow,1786,172,1614,7,120,3,4
18574,56205,0,0,deny,66,66,0,1,0,1,0
54201,445,0,0,drop,70,70,0,1,0,1,0
56252,445,0,0,drop,66,66,0,1,0,1,0
40120,23,0,0,deny,60,60,0,1,0,1,0
50586,443,6357,443,allow,2756,1594,1162,20,27,11,9
46640,8880,0,0,deny,60,60,0,1,0,1,0
49293,22,0,0,deny,60,60,0,1,0,1,0
49174,53,58915,53,allow,198,101,97,2,30,1,1
49407,53,19099,53,allow,209,102,107,2,30,1,1
63062,11392,0,0,deny,66,66,0,1,0,1,0
59122,80,13058,80,allow,2865,2000,865,12,16,7,5
50002,53,25520,53,allow,196,102,94,2,30,1,1
55630,53,24833,53,allow,197,102,95,2,30,1,1
57367,53,62826,53,allow,170,87,83,2,30,1,1
47910,7461,0,0,deny,60,60,0,1,0,1,0
48016,57470,0,0,deny,62,62,0,1,0,1,0
45341,443,7736,443,allow,2754,1394,1360,22,36,11,11
58751,443,12034,443,allow,10505,6856,3649,29,16,15,14
57343,53,10133,53,allow,214,86,128,2,29,1,1
49842,7302,0,0,deny,66,66,0,1,0,1,0
53403,445,0,0,drop,70,70,0,1,0,1,0
61392,50584,0,0,deny,62,62,0,1,0,1,0
45101,443,3854,443,allow,7912,2739,5173,26,516,14,12
59999,443,56048,443,allow,3047,1277,1770,16,144,8,8
56717,53,10005,53,allow,183,94,89,2,30,1,1
56313,53,27206,53,allow,198,102,96,2,30,1,1
60059,445,0,0,drop,66,66,0,1,0,1,0
2946,53,2946,53,allow,240,96,144,2,30,1,1
53741,445,0,0,drop,70,70,0,1,0,1,0
64856,53,25050,53,allow,451,124,327,4,45,2,2
56938,53,31467,53,allow,452,101,351,4,36,2,2
64894,53,19330,53,allow,195,102,93,2,30,1,1
48509,443,53083,443,allow,4922,950,3972,17,34,10,7
56328,53,20002,53,allow,214,102,112,2,31,1,1
62194,50584,0,0,deny,66,66,0,1,0,1,0
50700,80,7989,80,allow,142,142,0,1,5,1,0
46676,443,54715,443,allow,16425,3923,12502,37,156,19,18
59782,53,21953,53,allow,168,78,90,2,30,1,1
60793,53733,0,0,deny,66,66,0,1,0,1,0
49604,53,14213,53,allow,86,86,0,1,29,1,0
37042,53,37042,53,allow,237,98,139,2,30,1,1
50265,49893,64996,49893,allow,480,149,331,2,1200,1,1
53418,445,0,0,drop,66,66,0,1,0,1,0
63956,38211,0,0,deny,62,62,0,1,0,1,0
62099,445,0,0,drop,70,70,0,1,0,1,0
59278,445,0,0,drop,70,70,0,1,0,1,0
51015,64147,0,0,deny,62,62,0,1,0,1,0
55329,443,60850,443,allow,18284,2468,15816,42,26,22,20
49929,53,44359,53,allow,214,110,104,2,29,1,1
64776,50584,0,0,deny,66,66,0,1,0,1,0
53395,445,0,0,drop,66,66,0,1,0,1,0
56996,53,30047,53,allow,177,94,83,2,29,1,1
52128,21294,45027,21294,allow,70,70,0,1,4,1,0
58638,5900,0,0,deny,62,62,0,1,0,1,0
52288,443,59643,443,allow,38314,11683,26631,76,34,38,38
56753,44847,0,0,deny,62,62,0,1,0,1,0
54586,445,0,0,drop,70,70,0,1,0,1,0
55057,443,7517,443,allow,1364,940,424,12,16,7,5
63060,53,7236,53,allow,304,86,218,2,30,1,1
55650,53,4298,53,allow,179,94,85,2,29,1,1
63462,445,0,0,drop,70,70,0,1,0,1,0
50671,80,18183,80,allow,1658,1247,411,8,15,5,3
38945,443,48637,443,allow,20511,4206,16305,24,134,7,17
37629,443,33990,443,allow,172,172,0,2,5,2,0
43323,1,0,0,deny,62,62,0,1,0,1,0
10860,55108,0,0,deny,148,148,0,1,0,1,0
63182,445,0,0,drop,70,70,0,1,0,1,0
51441,443,28224,443,allow,322,66,256,6,16,2,4
31500,1,0,0,deny,146,146,0,1,0,1,0
53944,23280,32203,23280,allow,1740,834,906,16,16,10,6
64564,53,49143,53,allow,273,94,179,2,30,1,1
36536,53,36536,53,allow,414,268,146,3,32,2,1
56345,445,0,0,drop,70,70,0,1,0,1,0
52074,57947,10118,57947,allow,70,70,0,2,8,2,0
49665,53,16462,53,allow,168,86,82,2,32,1,1
13567,23684,0,0,deny,168,168,0,1,0,1,0
54204,443,50779,443,allow,18159,12786,5373,34,270,19,15
63690,445,0,0,drop,70,70,0,1,0,1,0
65240,53,20571,53,allow,453,186,267,6,30,3,3
27651,53,46551,53,allow,225,78,147,2,30,1,1
3304,80,1558,80,allow,2340,1419,921,10,15,5,5
50293,53,25447,53,allow,740,93,647,2,31,1,1
57244,443,45761,443,allow,230914,10401,220513,290,76,121,169
49667,53,65184,53,allow,448,184,264,6,30,3,3
38700,443,57335,443,allow,90113,3417,86696,95,16,30,65
46556,443,5923,443,allow,9316,1720,7596,25,16,13,12
52324,443,60831,443,allow,295493,16052,279441,394,68,186,208
57470,1930,53151,1930,allow,858,858,0,14,1199,14,0
64205,53,47320,53,allow,178,94,84,2,31,1,1
56385,445,0,0,drop,70,70,0,1,0,1,0
42959,443,5921,443,allow,795,795,0,2,154,2,0
56544,53,44845,53,allow,183,86,97,2,31,1,1
63918,445,0,0,drop,66,66,0,1,0,1,0
6881,32056,50769,32056,allow,509,150,359,2,1199,1,1
61477,443,48304,443,allow,30516,3311,27205,49,47,25,24
9226,57470,0,0,deny,66,66,0,1,0,1,0
38053,50584,0,0,deny,62,62,0,1,0,1,0
50426,443,9963,443,allow,5713,1079,4634,15,26,8,7
36933,23117,0,0,deny,66,66,0,1,0,1,0
3023,40108,0,0,deny,148,148,0,1,0,1,0
53898,12172,10905,12172,allow,70,70,0,2,7,2,0
62400,445,0,0,drop,70,70,0,1,0,1,0
60946,445,0,0,drop,70,70,0,1,0,1,0
49626,53,57027,53,allow,226,110,116,2,30,1,1
53160,39001,43902,39001,allow,70,70,0,1,5,1,0
55588,53,33228,53,allow,168,86,82,2,30,1,1
65121,53,39585,53,allow,440,94,346,4,37,2,2
35657,48637,0,0,deny,62,62,0,1,0,1,0
49413,443,21606,443,allow,7849,1104,6745,23,123,12,11
57275,443,62988,443,allow,45483074,398771,45084303,36307,333,3386,32921
11136,15503,0,0,deny,62,62,0,1,0,1,0
27777,80,27777,80,allow,12281469,369857,11911612,13837,31,5536,8301
63960,53,27823,53,allow,178,94,84,2,30,1,1
36893,67,0,0,deny,60,60,0,1,0,1,0
61938,443,24031,443,allow,3663,1097,2566,13,136,6,7
42366,57470,0,0,deny,66,66,0,1,0,1,0
57990,443,7309,443,allow,3182,1568,1614,8,120,4,4
38334,443,30322,443,allow,1864,250,1614,8,121,4,4
42298,40017,13967,40017,allow,148,86,62,2,30,1,1
48706,23393,0,0,deny,60,60,0,1,0,1,0
56258,53,50751,53,allow,772,103,669,2,30,1,1
65304,53,2754,53,allow,202,103,99,2,31,1,1
62549,53733,0,0,deny,66,66,0,1,0,1,0
55622,33342,63556,33342,allow,70,70,0,2,8,2,0
56383,445,0,0,drop,70,70,0,1,0,1,0
57288,443,16066,443,allow,7427,2084,5343,24,361,12,12
45051,23,0,0,deny,60,60,0,1,0,1,0
64029,38651,56654,38651,allow,66,66,0,2,7,2,0
64001,53,5288,53,allow,182,93,89,2,30,1,1
55323,443,19578,443,allow,229587,8510,221077,245,121,82,163
53928,15503,0,0,deny,62,62,0,1,0,1,0
53957,35440,0,0,deny,62,62,0,1,0,1,0
33525,443,32155,443,allow,8088,2191,5897,28,508,13,15
60802,445,0,0,drop,70,70,0,1,0,1,0
51313,40573,0,0,deny,100,100,0,1,0,1,0
49307,443,35042,443,allow,245382,6838,238544,214,31,44,170
38720,5222,21758,5222,allow,6262,2015,4247,35,48,17,18
56460,445,0,0,drop,70,70,0,1,0,1,0
49818,37965,0,0,deny,62,62,0,1,0,1,0
56400,35440,0,0,deny,66,66,0,1,0,1,0
56830,17793,18491,17793,allow,564,318,246,9,15,5,4
50453,445,0,0,drop,66,66,0,1,0,1,0
40161,443,23210,443,allow,13459,1604,11855,27,66,14,13
65373,53,50644,53,allow,197,102,95,2,31,1,1
64969,53,18068,53,allow,329,118,211,2,30,1,1
65524,53,9019,53,allow,386,122,264,4,52,2,2
65444,445,0,0,drop,70,70,0,1,0,1,0
3074,64147,0,0,deny,62,62,0,1,0,1,0
40288,80,46706,80,allow,1195,763,432,10,32,6,4
65324,53,6556,53,allow,749,94,655,2,30,1,1
42298,40039,40294,40039,allow,211,89,122,4,30,2,2
62765,16933,0,0,deny,66,66,0,1,0,1,0
41632,443,56228,443,allow,8507,4462,4045,27,141,14,13
31066,57470,0,0,deny,74,74,0,1,0,1,0
52270,3708,62556,3708,allow,316,136,180,6,6,3,3
41886,53,64973,53,allow,168,78,90,2,31,1,1
49658,53,46008,53,allow,195,102,93,2,29,1,1
58977,37965,0,0,deny,66,66,0,1,0,1,0
64017,53,52336,53,allow,209,110,99,2,30,1,1
27005,1402,23160,1402,allow,870,126,744,2,29,1,1
56602,80,9300,80,allow,234,234,0,4,11,4,0
0,0,0,0,deny,98,98,0,1,0,1,0
12465,9823,0,0,deny,146,146,0,1,0,1,0
39318,443,24928,443,allow,6933,2226,4707,33,140,18,15
55097,53,14648,53,allow,177,94,83,2,29,1,1
13794,3389,13794,3389,allow,3910,1805,2105,20,19,12,8
61373,445,0,0,drop,70,70,0,1,0,1,0
55778,53,21245,53,allow,189,102,87,2,29,1,1
52991,53,52991,53,allow,235,90,145,2,32,1,1
60473,8765,52424,8765,allow,1370,750,620,21,329,11,10
1038,37965,0,0,deny,62,62,0,1,0,1,0
59404,445,0,0,drop,66,66,0,1,0,1,0
56846,53,23614,53,allow,192,98,94,2,31,1,1
54204,445,0,0,drop,70,70,0,1,0,1,0
62149,22114,0,0,deny,66,66,0,1,0,1,0
49508,53,61449,53,allow,370,102,268,2,30,1,1
16319,44847,0,0,deny,146,146,0,1,0,1,0
49924,445,0,0,drop,66,66,0,1,0,1,0
51518,443,51518,443,allow,15967,3046,12921,39,173,15,24
38119,443,46487,443,allow,1820,1101,719,18,16,10,8
64817,445,0,0,drop,70,70,0,1,0,1,0
57258,53,16585,53,allow,177,94,83,2,30,1,1
53521,443,40751,443,allow,130,70,60,2,14,1,1
11648,37965,0,0,deny,145,145,0,1,0,1,0
62155,445,0,0,drop,70,70,0,1,0,1,0
55508,64147,0,0,deny,62,62,0,1,0,1,0
52169,59681,50827,59681,allow,70,70,0,2,8,2,0
55718,27025,19303,27025,allow,1778,1386,392,8,30,4,4
57182,445,0,0,drop,66,66,0,1,0,1,0
11450,57470,0,0,deny,66,66,0,1,0,1,0
60436,445,0,0,drop,66,66,0,1,0,1,0
37990,49152,47344,49152,allow,156,156,0,3,7,3,0
41153,53,8565,53,allow,168,78,90,2,30,1,1
1918,25174,0,0,deny,66,66,0,1,0,1,0
51063,445,0,0,drop,66,66,0,1,0,1,0
58760,443,41927,443,allow,45482,2178,43304,56,15,22,34
65183,445,0,0,drop,70,70,0,1,0,1,0
44380,443,20721,443,allow,5624,2556,3068,29,80,15,14
36765,80,13699,80,allow,2272,1679,593,10,34,6,4
57772,445,0,0,drop,70,70,0,1,0,1,0
50584,56112,8598,56112,allow,1377,300,1077,6,1200,3,3
50313,445,0,0,drop,70,70,0,1,0,1,0
62709,57470,0,0,deny,62,62,0,1,0,1,0
52318,22114,0,0,deny,62,62,0,1,0,1,0
60291,53,5136,53,allow,78,78,0,1,30,1,0
65117,53,1871,53,allow,198,102,96,2,30,1,1
37563,443,52126,443,allow,499,425,74,4,0,3,1
54038,445,0,0,drop,66,66,0,1,0,1,0
57734,445,0,0,drop,70,70,0,1,0,1,0
51947,443,7702,443,allow,3893,2046,1847,29,56,16,13
63300,445,0,0,drop,70,70,0,1,0,1,0
52332,443,60314,443,allow,15746,4302,11444,17,122,5,12
60568,445,0,0,drop,66,66,0,1,0,1,0
64159,445,0,0,drop,70,70,0,1,0,1,0
41284,443,45151,443,allow,7252,2147,5105,18,136,8,10
49685,80,12171,80,allow,1548,847,701,10,16,5,5
27005,27018,42247,27018,allow,881,126,755,2,30,1,1
13907,57470,0,0,deny,66,66,0,1,0,1,0
53817,443,11999,443,allow,7443,2043,5400,34,255,17,17
56582,23718,0,0,deny,62,62,0,1,0,1,0
58638,5900,0,0,deny,62,62,0,1,0,1,0
60813,443,60813,443,allow,1386,751,635,15,182,8,7
59347,445,0,0,drop,70,70,0,1,0,1,0
19473,28867,41961,28867,allow,480,149,331,2,1200,1,1
50116,22,50116,22,allow,152,66,86,2,9,1,1
39500,443,7473,443,allow,6517,2048,4469,21,90,12,9
33367,80,33367,80,allow,424,198,226,7,141,4,3
50982,445,0,0,drop,66,66,0,1,0,1,0
58930,60038,0,0,allow,66,66,0,1,91,1,0
52092,443,18467,443,allow,13078,7055,6023,114,162,59,55
63469,445,0,0,drop,70,70,0,1,0,1,0
51923,445,0,0,drop,70,70,0,1,0,1,0
33965,443,25810,443,allow,1409634,52704,1356930,1536,173,533,1003
54886,443,54886,443,allow,136775,6729,130046,181,18,82,99
64616,445,0,0,drop,70,70,0,1,0,1,0
42298,40005,17939,40005,allow,263,182,81,2,30,1,1
34141,53,34141,53,allow,217,87,130,2,30,1,1
37562,443,51859,443,allow,13836,6371,7465,34,23,20,14
1903,43890,0,0,deny,62,62,0,1,0,1,0
57095,53,1337,53,allow,211,110,101,2,29,1,1
57433,21247,0,0,deny,66,66,0,1,0,1,0
55330,53,64550,53,allow,194,102,92,2,31,1,1
47910,7454,0,0,deny,60,60,0,1,0,1,0
15266,55783,0,0,deny,145,145,0,1,0,1,0
57669,64147,0,0,deny,66,66,0,1,0,1,0
59985,57470,0,0,deny,62,62,0,1,0,1,0
56671,443,62348,443,allow,8300,3581,4719,25,19,15,10
53715,445,0,0,drop,70,70,0,1,0,1,0
51136,445,0,0,drop,70,70,0,1,0,1,0
64324,53,8144,53,allow,179,94,85,2,30,1,1
45395,53,0,0,allow,86,86,0,1,30,1,0
55330,53,4334,53,allow,216,102,114,2,30,1,1
53962,16251,51780,16251,allow,70,70,0,1,4,1,0
61159,445,0,0,drop,66,66,0,1,0,1,0
64873,53,26833,53,allow,380,110,270,2,30,1,1
55325,53,12048,53,allow,762,101,661,2,30,1,1
50255,53,26984,53,allow,199,102,97,2,30,1,1
6880,31359,0,0,deny,107,107,0,1,0,1,0
54742,50584,0,0,deny,66,66,0,1,0,1,0
61898,50584,0,0,deny,66,66,0,1,0,1,0
63991,443,63991,443,allow,4597,1690,2907,19,28,11,8
50930,445,0,0,drop,66,66,0,1,0,1,0
15503,56331,21797,56331,allow,481,150,331,2,1200,1,1
56335,53,52497,53,allow,193,102,91,2,30,1,1
6889,8055,0,0,deny,143,143,0,1,0,1,0
51548,445,0,0,drop,70,70,0,1,0,1,0
44894,443,39327,443,allow,1849,1130,719,17,36,9,8
19570,50584,0,0,deny,62,62,0,1,0,1,0
62855,445,0,0,drop,70,70,0,1,0,1,0
58638,5900,0,0,deny,62,62,0,1,0,1,0
58866,443,52755,443,allow,2353,1453,900,16,15,8,8
52459,3399,0,0,deny,60,60,0,1,0,1,0
63996,45759,44503,45759,allow,70,70,0,1,5,1,0
61751,445,0,0,drop,70,70,0,1,0,1,0
64428,53,26819,53,allow,299,97,202,4,44,2,2
6189,53,29429,53,allow,229,86,143,2,30,1,1
60424,6881,10732,6881,allow,320,140,180,6,7,3,3
65099,445,0,0,drop,70,70,0,1,0,1,0
45912,44847,0,0,deny,146,146,0,1,0,1,0
51551,445,0,0,drop,70,70,0,1,0,1,0
14869,44847,0,0,deny,62,62,0,1,0,1,0
49657,443,35292,443,allow,2800,1557,1243,33,53,19,14
62210,445,0,0,drop,70,70,0,1,0,1,0
56427,53,1277,53,allow,178,94,84,2,30,1,1
37569,443,62678,443,allow,214,140,74,4,15,3,1
63403,445,0,0,drop,70,70,0,1,0,1,0
64424,53,20113,53,allow,194,94,100,2,30,1,1
38363,15000,1161,15000,allow,130,70,60,2,6,1,1
60971,443,28807,443,allow,396507,14667,381840,458,21,171,287
64705,53,6395,53,allow,213,102,111,2,30,1,1
65427,443,32092,443,allow,14205,1527,12678,13,147,2,11
64655,443,35493,443,allow,8903,2857,6046,22,135,10,12
37653,5223,53311,5223,allow,70,70,0,1,5,1,0
56041,53,39211,53,allow,185,102,83,2,31,1,1
49815,443,20999,443,allow,3964,780,3184,14,125,8,6
55200,53,50421,53,allow,209,110,99,2,30,1,1
57114,35440,0,0,deny,146,146,0,1,0,1,0
55996,53,10816,53,allow,168,86,82,2,30,1,1
54749,443,23422,443,allow,273283,194709,78574,1567,3312,746,821
51887,16514,28256,16514,allow,70,70,0,1,5,1,0
34883,443,14501,443,allow,51393,3538,47855,70,30,29,41
58348,445,0,0,drop,70,70,0,1,0,1,0
52420,445,0,0,drop,70,70,0,1,0,1,0
58803,443,12977,443,allow,5166,700,4466,16,15,7,9
50460,443,50460,443,allow,1159,668,491,11,31,6,5
58938,443,4576,443,allow,6035,770,5265,18,15,8,10
57375,53,58111,53,allow,247,102,145,2,30,1,1
50593,64147,0,0,deny,62,62,0,1,0,1,0
52010,445,0,0,drop,70,70,0,1,0,1,0
28699,53,53419,53,allow,278,86,192,2,30,1,1
60159,22114,0,0,deny,62,62,0,1,0,1,0
57239,53,63537,53,allow,186,95,91,2,31,1,1
51879,443,43940,443,allow,4418,1116,3302,17,30,10,7
60097,445,0,0,drop,70,70,0,1,0,1,0
65428,53,7407,53,allow,731,85,646,2,31,1,1
53398,443,48527,443,allow,5196,2308,2888,34,137,16,18
64649,53,56977,53,allow,184,94,90,2,30,1,1
17010,57470,0,0,deny,62,62,0,1,0,1,0
4781,443,51838,443,allow,1191,692,499,12,40,7,5
53165,445,0,0,drop,70,70,0,1,0,1,0
25776,53,25776,53,allow,233,90,143,2,32,1,1
12348,50265,0,0,deny,62,62,0,1,0,1,0
55076,53,43465,53,allow,183,94,89,2,30,1,1
49663,53,0,0,allow,86,86,0,1,30,1,0
56204,53,16211,53,allow,195,102,93,2,30,1,1
62821,445,0,0,drop,66,66,0,1,0,1,0
22683,39210,0,0,deny,60,60,0,1,0,1,0
65518,53,59686,53,allow,211,102,109,2,30,1,1
56715,53,50292,53,allow,807,94,713,2,30,1,1
3591,53,3591,53,allow,235,90,145,2,32,1,1
51914,445,0,0,drop,66,66,0,1,0,1,0
49618,53,25113,53,allow,774,101,673,2,30,1,1
49800,53,35452,53,allow,485,93,392,4,48,2,2
60382,62582,18649,62582,allow,70,70,0,2,8,2,0
61287,445,0,0,drop,66,66,0,1,0,1,0
33151,53,41502,53,allow,168,78,90,2,30,1,1
53318,80,64678,80,allow,1536,982,554,10,76,6,4
51497,443,10165,443,allow,350,210,140,6,14,4,2
35517,443,27389,443,allow,130,70,60,3,5,2,1
57289,31573,0,0,deny,62,62,0,1,0,1,0
57816,445,0,0,drop,70,70,0,1,0,1,0
56090,445,0,0,drop,70,70,0,1,0,1,0
52055,20019,40122,20019,allow,316,136,180,6,7,3,3
8889,2117,0,0,deny,60,60,0,1,0,1,0
47413,23,0,0,deny,60,60,0,1,0,1,0
64731,53,43372,53,allow,241,110,131,2,30,1,1
53981,445,0,0,drop,70,70,0,1,0,1,0
26900,27017,49129,27017,allow,422,164,258,6,30,3,3
49673,53,51744,53,allow,421,88,333,4,39,2,2
54074,443,19199,443,allow,72465,3991,68474,98,169,43,55
63360,445,0,0,drop,70,70,0,1,0,1,0
59833,443,63196,443,allow,15252,5376,9876,35,154,16,19
58247,57866,0,0,deny,66,66,0,1,0,1,0
65221,445,0,0,drop,66,66,0,1,0,1,0
59734,445,0,0,drop,66,66,0,1,0,1,0
56574,53,4025,53,allow,198,94,104,2,30,1,1
36942,53,36942,53,allow,197,90,107,2,30,1,1
58004,80,58289,80,allow,14922,10566,4356,39,75,20,19
63140,30685,24929,30685,allow,70,70,0,1,5,1,0
53668,50678,24375,50678,allow,70,70,0,2,7,2,0
59837,445,0,0,drop,66,66,0,1,0,1,0
49243,53,19778,53,allow,212,102,110,2,30,1,1
53110,8830,57205,8830,allow,70,70,0,1,5,1,0
63962,53,22978,53,allow,274,93,181,4,64,2,2
58986,445,0,0,drop,70,70,0,1,0,1,0
53744,443,46972,443,allow,499,425,74,4,0,3,1
59851,445,0,0,drop,66,66,0,1,0,1,0
50740,443,2714,443,allow,3108,1730,1378,16,16,9,7
57300,53,58923,53,allow,184,94,90,2,31,1,1
18331,53,15455,53,allow,376,94,282,2,30,1,1
50635,443,12337,443,allow,8252,1702,6550,26,72,13,13
61817,445,0,0,drop,70,70,0,1,0,1,0
47030,81,0,0,deny,60,60,0,1,0,1,0
61030,443,16792,443,allow,109010,37307,71703,152,895,62,90
64694,53,22388,53,allow,289,82,207,4,46,2,2
56866,53,52471,53,allow,194,102,92,2,30,1,1
39588,25174,0,0,deny,66,66,0,1,0,1,0
56386,53,9835,53,allow,177,94,83,2,31,1,1
56388,22114,0,0,deny,66,66,0,1,0,1,0
63340,53,0,0,deny,84,84,0,1,0,1,0
52572,80,52572,80,allow,1899,1310,589,12,48,6,6
51996,41888,46821,41888,allow,70,70,0,1,4,1,0
10632,25174,0,0,deny,146,146,0,1,0,1,0
37662,2323,0,0,deny,60,60,0,1,0,1,0
14429,443,41458,443,allow,4118,2905,1213,27,87,16,11
4782,443,2792,443,allow,1191,692,499,12,39,7,5
42046,443,15950,443,allow,10195,2175,8020,25,187,14,11
58987,445,0,0,drop,70,70,0,1,0,1,0
59485,445,0,0,drop,70,70,0,1,0,1,0
54420,443,57977,443,allow,5809,1552,4257,19,74,11,8
64931,53,32751,53,allow,174,89,85,2,31,1,1
58732,443,10734,443,allow,1038,502,536,16,33,8,8
53283,445,0,0,drop,70,70,0,1,0,1,0
53238,443,61389,443,allow,13597,1371,12226,26,323,11,15
61122,445,0,0,drop,70,70,0,1,0,1,0
65382,53,24981,53,allow,301,108,193,4,54,2,2
27005,27015,15539,27015,allow,881,126,755,2,30,1,1
56164,53,3250,53,allow,226,110,116,2,30,1,1
37961,443,30943,443,allow,10229,2777,7452,30,361,15,15
56063,53,65199,53,allow,192,98,94,2,31,1,1
49532,53,18389,53,allow,443,182,261,6,31,3,3
65464,443,36070,443,allow,395647,11870,383777,409,16,144,265
64816,123,36690,123,allow,184,94,90,2,30,1,1
26900,27017,33518,27017,allow,422,164,258,6,30,3,3
45525,53,45525,53,allow,469,165,304,4,30,2,2
59008,51221,0,0,deny,66,66,0,1,0,1,0
56996,445,0,0,drop,70,70,0,1,0,1,0
52189,443,26207,443,allow,4688,3009,1679,33,80,17,16
65201,445,0,0,drop,70,70,0,1,0,1,0
6057,51221,0,0,deny,78,78,0,1,0,1,0
62825,445,0,0,drop,70,70,0,1,0,1,0
53769,8999,60336,8999,allow,70,70,0,1,5,1,0
47771,25174,0,0,deny,146,146,0,1,0,1,0
53269,443,51596,443,allow,5766,1925,3841,22,17,14,8
50374,53,63648,53,allow,755,102,653,2,29,1,1
60340,80,29761,80,allow,9406,1913,7493,14,16,7,7
50442,37807,0,0,deny,62,62,0,1,0,1,0
58924,445,0,0,drop,70,70,0,1,0,1,0
56703,53,19999,53,allow,199,102,97,2,30,1,1
56127,37965,0,0,deny,62,62,0,1,0,1,0
58999,445,0,0,drop,66,66,0,1,0,1,0
1090,26296,0,0,deny,159,159,0,1,0,1,0
52982,25174,0,0,deny,146,146,0,1,0,1,0
54743,443,47896,443,allow,166136,7244,158892,202,149,76,126
47655,53,46246,53,allow,168,78,90,2,29,1,1
58836,51505,0,0,deny,66,66,0,1,0,1,0
58786,445,0,0,drop,66,66,0,1,0,1,0
55120,445,0,0,drop,70,70,0,1,0,1,0
56629,53,25209,53,allow,183,94,89,2,30,1,1
58338,3375,0,0,deny,60,60,0,1,0,1,0
41267,443,45130,443,allow,8248,876,7372,25,186,9,16
50336,53,8935,53,allow,102,102,0,1,30,1,0
26497,64147,0,0,deny,66,66,0,1,0,1,0
33259,443,58382,443,allow,4193,2689,1504,23,23,14,9
60036,445,0,0,drop,70,70,0,1,0,1,0
50577,53,42323,53,allow,819,102,717,2,30,1,1
53583,15354,6378,15354,allow,70,70,0,2,7,2,0
57328,443,39932,443,allow,134,60,74,3,4,2,1
46587,57470,0,0,deny,62,62,0,1,0,1,0
56225,53,8973,53,allow,194,102,92,2,29,1,1
34717,53,24183,53,allow,168,78,90,2,31,1,1
60312,57470,0,0,deny,74,74,0,1,0,1,0
61750,445,0,0,drop,70,70,0,1,0,1,0
56883,445,0,0,drop,66,66,0,1,0,1,0
54932,443,37338,443,allow,84306,6712,77594,156,236,58,98
64159,445,0,0,drop,70,70,0,1,0,1,0
63797,445,0,0,drop,70,70,0,1,0,1,0
49153,53,32682,53,allow,214,102,112,2,29,1,1
53253,443,36100,443,allow,8662,1469,7193,28,66,15,13
57015,42707,0,0,deny,62,62,0,1,0,1,0
55421,53,44471,53,allow,200,102,98,2,30,1,1
2919,57866,0,0,deny,62,62,0,1,0,1,0
53536,445,0,0,drop,66,66,0,1,0,1,0
51691,5543,12224,5543,allow,70,70,0,1,5,1,0
49994,443,47759,443,allow,352,292,60,2,5,1,1
55365,53,26447,53,allow,184,94,90,2,30,1,1
64722,443,16301,443,allow,61890,2830,59060,73,120,27,46
60581,445,0,0,drop,70,70,0,1,0,1,0
56000,53,42944,53,allow,177,94,83,2,30,1,1
4257,35440,0,0,deny,62,62,0,1,0,1,0
55475,80,10225,80,allow,350,210,140,6,27,4,2
37965,51413,62222,51413,allow,158,158,0,1,1200,1,0
55867,53,6696,53,allow,184,94,90,2,30,1,1
24110,23,0,0,deny,60,60,0,1,0,1,0
48022,5228,46270,5228,allow,10096,2251,7845,41,3747,16,25
56543,443,33644,443,allow,8659,1687,6972,30,55,16,14
6889,30170,0,0,deny,143,143,0,1,0,1,0
60915,445,0,0,drop,70,70,0,1,0,1,0
51869,25355,56016,25355,allow,70,70,0,1,5,1,0
48012,443,51500,443,allow,1429,1295,134,10,29,8,2
50516,443,49495,443,allow,12855,2077,10778,30,78,15,15
53154,443,28335,443,allow,3947,2796,1151,22,28,12,10
57120,445,0,0,drop,66,66,0,1,0,1,0
65180,53,28162,53,allow,199,102,97,2,30,1,1
5690,23,0,0,deny,60,60,0,1,0,1,0
48839,37807,0,0,deny,146,146,0,1,0,1,0
55972,53,10428,53,allow,186,95,91,2,30,1,1
57987,56125,0,0,deny,90,90,0,1,0,1,0
53588,8999,41805,8999,allow,1268,960,308,9,32,5,4
49636,53,12225,53,allow,180,94,86,2,30,1,1
59060,50584,0,0,deny,62,62,0,1,0,1,0
39927,443,15384,443,allow,7787,2370,5417,23,242,11,12
65515,445,0,0,drop,66,66,0,1,0,1,0
56596,53,50700,53,allow,199,102,97,2,30,1,1
42019,443,22698,443,allow,21620,7973,13647,112,488,57,55
55606,445,0,0,drop,70,70,0,1,0,1,0
64710,53,46845,53,allow,393,110,283,2,30,1,1
63043,445,0,0,drop,70,70,0,1,0,1,0
58638,5900,0,0,deny,62,62,0,1,0,1,0
50560,80,54497,80,allow,318,192,126,6,26,4,2
65277,53,40732,53,allow,199,102,97,2,30,1,1
65185,27126,57830,27126,allow,268,78,190,2,30,1,1
51675,53,24941,53,allow,168,78,90,2,29,1,1
57427,445,0,0,drop,70,70,0,1,0,1,0
64624,445,0,0,drop,70,70,0,1,0,1,0
53656,11119,0,0,deny,148,148,0,1,0,1,0
49695,445,0,0,drop,70,70,0,1,0,1,0
53773,443,19967,443,allow,499,425,74,4,0,3,1
53959,445,0,0,drop,66,66,0,1,0,1,0
52478,443,31557,443,allow,7985,2085,5900,18,121,8,10
60911,53,23878,53,allow,335,78,257,2,29,1,1
51041,445,0,0,drop,70,70,0,1,0,1,0
59839,443,29303,443,allow,93467,4007,89460,107,22,33,74
25448,23,25448,23,allow,66,66,0,1,5,1,0
56893,53,20902,53,allow,177,94,83,2,31,1,1
49533,443,49533,443,allow,20402,16563,3839,29,24,17,12
56115,53,38646,53,allow,278,96,182,4,54,2,2
50491,443,32943,443,allow,28729,1634,27095,40,120,16,24
36291,53,42350,53,allow,199,94,105,2,31,1,1
51694,80,56366,80,allow,1307,649,658,8,75,5,3
27005,27268,57130,27268,allow,884,126,758,2,30,1,1
53720,50795,49301,50795,allow,320,140,180,6,7,3,3
58638,5900,0,0,deny,62,62,0,1,0,1,0
49826,443,35074,443,allow,5635,1599,4036,19,125,11,8
57929,53,0,0,allow,294,86,208,2,30,1,1
65055,53,62687,53,allow,225,86,139,2,30,1,1
55037,445,0,0,drop,70,70,0,1,0,1,0
39175,80,7841,80,allow,1712,1324,388,11,16,5,6
58638,5900,0,0,deny,62,62,0,1,0,1,0
50422,445,0,0,drop,66,66,0,1,0,1,0
58712,80,8787,80,allow,4176,3453,723,14,15,7,7
45392,443,53669,443,allow,1312,651,661,13,185,7,6
50464,445,0,0,drop,70,70,0,1,0,1,0
49710,53,37323,53,allow,179,94,85,2,30,1,1
39718,443,11292,443,allow,10186,3128,7058,26,16,13,13
55580,445,0,0,drop,70,70,0,1,0,1,0
57312,53,15531,53,allow,212,110,102,2,30,1,1
50455,445,0,0,drop,70,70,0,1,0,1,0
52506,445,0,0,drop,70,70,0,1,0,1,0
49504,443,29645,443,allow,26816,2982,23834,50,270,23,27
15998,36829,0,0,deny,62,62,0,1,0,1,0
49722,443,17749,443,allow,5943,850,5093,16,50,7,9
56704,53,2195,53,allow,177,94,83,2,30,1,1
44960,443,32145,443,allow,306066,33556,272510,414,196,162,252
60417,55100,62868,55100,allow,164,70,94,2,5,1,1
65092,53,28213,53,allow,197,102,95,2,29,1,1
45855,25174,0,0,deny,62,62,0,1,0,1,0
65360,445,0,0,drop,70,70,0,1,0,1,0
60400,80,41884,80,allow,1704,808,896,10,122,6,4
50475,445,0,0,drop,66,66,0,1,0,1,0
39194,53,39194,53,allow,414,268,146,3,32,2,1
51236,445,0,0,drop,70,70,0,1,0,1,0
16225,443,41335,443,allow,13126,5105,8021,37,31,21,16
64880,53,46886,53,allow,164,84,80,2,30,1,1
47337,443,13338,443,allow,14281,2906,11375,15,122,4,11
53703,16426,15322,16426,allow,70,70,0,2,7,2,0
58856,443,36240,443,allow,6350667,198580,6152087,6885,451,2497,4388
50516,443,44017,443,allow,1575,771,804,16,47,9,7
47747,443,43132,443,allow,4187,1350,2837,18,321,8,10
38406,443,5076,443,allow,564,292,272,9,26,5,4
29025,53,29025,53,allow,235,90,145,2,31,1,1
31675,23,0,0,deny,60,60,0,1,0,1,0
37655,443,41125,443,allow,9811,3415,6396,29,46,17,12
50063,35776,0,0,deny,148,148,0,1,0,1,0
26900,27017,12522,27017,allow,422,164,258,6,30,3,3
22783,64147,0,0,deny,62,62,0,1,0,1,0
52778,445,0,0,drop,70,70,0,1,0,1,0
41395,443,34255,443,allow,6292,1492,4800,22,17,11,11
64793,53,53457,53,allow,184,94,90,2,30,1,1
37998,49152,32246,49152,allow,156,156,0,3,8,3,0
55107,53,60503,53,allow,816,102,714,2,30,1,1
53092,443,57966,443,allow,8071,1789,6282,20,326,10,10
52033,37905,61391,37905,allow,70,70,0,2,8,2,0
31112,50584,0,0,deny,66,66,0,1,0,1,0
56770,26467,0,0,deny,66,66,0,1,0,1,0
25363,22114,0,0,deny,66,66,0,1,0,1,0
58245,445,0,0,drop,70,70,0,1,0,1,0
60501,443,35631,443,allow,12006,3698,8308,23,15,13,10
56948,445,0,0,drop,66,66,0,1,0,1,0
14692,25174,0,0,deny,62,62,0,1,0,1,0
64309,53,55479,53,allow,549,188,361,6,57,3,3
49597,53,32706,53,allow,168,86,82,2,31,1,1
56997,123,16433,123,allow,184,94,90,2,30,1,1
50236,443,50711,443,allow,6661,1489,5172,26,270,13,13
58431,443,11477,443,allow,5771,3201,2570,22,161,10,12
54601,26467,0,0,deny,66,66,0,1,0,1,0
58022,88,0,0,deny,60,60,0,1,0,1,0
49379,53,1311,53,allow,198,101,97,2,30,1,1
63391,445,0,0,drop,70,70,0,1,0,1,0
60794,20010,30261,20010,allow,70,70,0,2,8,2,0
36144,443,36144,443,allow,170890,13800,157090,246,97,123,123
53094,445,0,0,drop,66,66,0,1,0,1,0
37749,15503,0,0,deny,62,62,0,1,0,1,0
64490,445,0,0,drop,70,70,0,1,0,1,0
53676,35974,0,0,deny,60,60,0,1,0,1,0
27005,27237,41184,27237,allow,891,126,765,2,30,1,1
49874,443,3516,443,allow,6058,1037,5021,20,54,11,9
64637,53,50285,53,allow,188,96,92,2,30,1,1
59787,443,50421,443,allow,173218,14836,158382,227,48,114,113
21133,26760,14164,26760,allow,480,149,331,2,1200,1,1
54867,445,0,0,drop,70,70,0,1,0,1,0
62424,445,0,0,drop,70,70,0,1,0,1,0
43705,443,47459,443,allow,8060,2001,6059,24,19,14,10
54837,445,0,0,drop,66,66,0,1,0,1,0
56758,53,14411,53,allow,165,86,79,2,30,1,1
49225,443,22877,443,allow,11707,2326,9381,28,19,14,14
52549,445,0,0,drop,66,66,0,1,0,1,0
30960,45721,23609,45721,allow,66,66,0,1,3600,1,0
51690,80,52942,80,allow,21064,2772,18292,38,175,18,20
58283,443,44449,443,allow,42792,12402,30390,98,370,45,53
63136,443,35141,443,allow,6781,1289,5492,17,15,9,8
61416,80,26249,80,allow,2366,764,1602,10,137,5,5
57090,53,28237,53,allow,198,102,96,2,30,1,1
37176,80,24453,80,allow,941,526,415,11,315,6,5
63991,80,39490,80,allow,314,192,122,6,15,4,2
64403,53,23409,53,allow,193,102,91,2,30,1,1
58408,445,0,0,drop,70,70,0,1,0,1,0
56864,53,65006,53,allow,200,102,98,2,31,1,1
64690,53,18350,53,allow,338,110,228,2,30,1,1
52002,53,64717,53,allow,289,86,203,2,30,1,1
10965,22114,0,0,deny,62,62,0,1,0,1,0
58396,22114,0,0,deny,66,66,0,1,0,1,0
50575,53,21343,53,allow,184,94,90,2,30,1,1
49274,445,0,0,drop,66,66,0,1,0,1,0
57982,64147,0,0,deny,66,66,0,1,0,1,0
27448,22114,0,0,deny,62,62,0,1,0,1,0
51269,36983,55294,36983,allow,70,70,0,2,8,2,0
50265,12656,39117,12656,allow,402,132,270,6,1209,3,3
27055,25174,0,0,deny,62,62,0,1,0,1,0
65465,53,17852,53,allow,755,102,653,2,29,1,1
51383,445,0,0,drop,66,66,0,1,0,1,0
49602,445,0,0,drop,70,70,0,1,0,1,0
42469,30188,0,0,deny,62,62,0,1,0,1,0
43231,443,33460,443,allow,56226,4852,51374,71,106,30,41
55665,44235,23820,44235,allow,504,318,186,8,15,5,3
53223,445,0,0,drop,66,66,0,1,0,1,0
45523,443,20387,443,allow,8636,1914,6722,31,95,16,15
26058,1433,0,0,deny,60,60,0,1,0,1,0
57229,445,0,0,drop,70,70,0,1,0,1,0
41688,443,15969,443,allow,626036,38764,587272,713,191,245,468
50020,443,25948,443,allow,9175,2213,6962,37,121,19,18
52938,64097,0,0,deny,66,66,0,1,0,1,0
57931,445,0,0,drop,70,70,0,1,0,1,0
64781,53,27529,53,allow,209,102,107,2,30,1,1
53090,59356,0,0,deny,66,66,0,1,0,1,0
57052,53,26525,53,allow,177,94,83,2,30,1,1
38484,48637,0,0,deny,60,60,0,1,0,1,0
49216,53,26832,53,allow,401,142,259,2,30,1,1
64273,53,19409,53,allow,256,102,154,2,30,1,1
51094,35440,0,0,deny,66,66,0,1,0,1,0
51232,23,0,0,deny,60,60,0,1,0,1,0
52248,9323,44483,9323,allow,210,70,140,4,8,2,2
50560,443,29461,443,allow,408090,25873,382217,748,137,354,394
37322,53,64245,53,allow,168,78,90,2,31,1,1
41630,15000,14960,15000,allow,130,70,60,2,5,1,1
65084,53,19424,53,allow,215,102,113,2,29,1,1
16387,26637,0,0,allow,60,60,0,1,61,1,0
3478,61463,0,0,deny,921,921,0,1,0,1,0
56655,53,60599,53,allow,168,86,82,2,31,1,1
50052,65008,0,0,deny,60,60,0,1,0,1,0
54636,26467,0,0,deny,62,62,0,1,0,1,0
55657,37273,33354,37273,allow,70,70,0,2,8,2,0
50219,53,44100,53,allow,751,95,656,2,31,1,1
22751,53,22751,53,allow,235,90,145,2,32,1,1
29029,53,43871,53,allow,323,77,246,4,30,2,2
50957,445,0,0,drop,70,70,0,1,0,1,0
64554,445,0,0,drop,66,66,0,1,0,1,0
49875,53,51820,53,allow,399,86,313,4,49,2,2
49620,443,22598,443,allow,4565,3479,1086,13,138,8,5
50338,80,9655,80,allow,2668,870,1798,13,47,7,6
44710,443,12033,443,allow,13320,3575,9745,38,26,19,19
57983,443,8445,443,allow,315701,12378,303323,358,137,129,229
38350,80,18584,80,allow,1678,1364,314,10,16,5,5
57052,53,38641,53,allow,177,94,83,2,30,1,1
50077,443,55619,443,allow,1786,172,1614,7,0,3,4
35112,8635,35112,8635,allow,138,78,60,2,5,1,1
7749,36237,0,0,deny,66,66,0,1,0,1,0
50280,53,42526,53,allow,794,102,692,2,30,1,1
56481,53,4723,53,allow,193,102,91,2,30,1,1
65085,53,47896,53,allow,196,94,102,2,30,1,1
55224,53,59301,53,allow,180,92,88,2,31,1,1
61753,445,0,0,drop,70,70,0,1,0,1,0
49168,57470,0,0,deny,66,66,0,1,0,1,0
64055,53,63061,53,allow,178,91,87,2,31,1,1
56583,443,5338,443,allow,9416,2366,7050,25,19,14,11
55209,445,0,0,drop,70,70,0,1,0,1,0
55287,445,0,0,drop,66,66,0,1,0,1,0
36712,53,0,0,allow,138,69,69,2,30,1,1
56357,445,0,0,drop,70,70,0,1,0,1,0
56604,17372,0,0,deny,66,66,0,1,0,1,0
23218,62413,0,0,deny,66,66,0,1,0,1,0
60066,80,60066,80,allow,355862,9048,346814,358,163,116,242
13970,42873,0,0,deny,66,66,0,1,0,1,0
23274,50584,0,0,deny,146,146,0,1,0,1,0
27005,27018,60808,27018,allow,881,126,755,2,31,1,1
57150,53,63337,53,allow,286,97,189,4,47,2,2
43639,26467,0,0,deny,66,66,0,1,0,1,0
1821,64147,0,0,deny,66,66,0,1,0,1,0
56929,53,55156,53,allow,784,94,690,2,30,1,1
61497,443,26455,443,allow,15302,2355,12947,30,32,14,16
55488,445,0,0,drop,70,70,0,1,0,1,0
45964,7776,0,0,deny,60,60,0,1,0,1,0
50961,5222,36046,5222,allow,8318,2850,5468,54,255,27,27
33664,80,64127,80,allow,3667,1654,2013,20,189,11,9
60337,30188,0,0,deny,66,66,0,1,0,1,0
15403,51505,0,0,deny,66,66,0,1,0,1,0
50034,53,9396,53,allow,174,89,85,2,30,1,1
14360,64147,0,0,deny,145,145,0,1,0,1,0
55910,53,26815,53,allow,183,94,89,2,30,1,1
40547,24051,0,0,deny,74,74,0,1,0,1,0
49911,53,3623,53,allow,200,94,106,2,30,1,1
49552,53,59587,53,allow,188,96,92,2,30,1,1
62249,443,58132,443,allow,9251,6353,2898,25,120,13,12
51765,80,50481,80,allow,5569,3270,2299,21,74,13,8
53134,42369,45499,42369,allow,70,70,0,2,8,2,0
52431,50265,0,0,deny,62,62,0,1,0,1,0
51690,445,0,0,drop,70,70,0,1,0,1,0
61635,37965,0,0,deny,66,66,0,1,0,1,0
61675,80,46507,80,allow,5108,676,4432,14,15,7,7
49562,53,45656,53,allow,380,90,290,4,48,2,2
1040,37965,0,0,deny,62,62,0,1,0,1,0
39244,36829,0,0,deny,62,62,0,1,0,1,0
10416,64147,0,0,deny,62,62,0,1,0,1,0
14023,37965,0,0,deny,62,62,0,1,0,1,0
57470,46501,13184,46501,allow,132,132,0,3,1199,3,0
57701,445,0,0,drop,70,70,0,1,0,1,0
55858,445,0,0,drop,66,66,0,1,0,1,0
55541,53,53785,53,allow,772,100,672,2,31,1,1
56456,53,45669,53,allow,199,102,97,2,30,1,1
64612,445,0,0,drop,66,66,0,1,0,1,0
52053,445,0,0,drop,70,70,0,1,0,1,0
55559,53,59475,53,allow,182,94,88,2,30,1,1
49451,445,0,0,drop,70,70,0,1,0,1,0
57998,445,0,0,drop,66,66,0,1,0,1,0
49182,445,0,0,drop,66,66,0,1,0,1,0
42298,40012,32444,40012,allow,148,86,62,2,29,1,1
55012,25174,0,0,deny,66,66,0,1,0,1,0
51931,443,20564,443,allow,2328,1677,651,17,23,9,8
36471,443,15597,443,allow,83203,3599,79604,101,138,41,60
50862,445,0,0,drop,70,70,0,1,0,1,0
46542,443,1363,443,allow,5916,1144,4772,20,17,11,9
52860,445,0,0,drop,70,70,0,1,0,1,0
51815,51221,0,0,deny,74,74,0,1,0,1,0
54772,443,51519,443,allow,3388,894,2494,19,154,8,11
50652,445,0,0,drop,70,70,0,1,0,1,0
33992,53,33992,53,allow,79,79,0,1,30,1,0
63539,445,0,0,drop,70,70,0,1,0,1,0
51584,445,0,0,drop,70,70,0,1,0,1,0
51941,19333,28791,19333,allow,70,70,0,2,8,2,0
55958,53,25725,53,allow,209,102,107,2,30,1,1
51705,22114,0,0,deny,66,66,0,1,0,1,0
47783,50432,0,0,deny,62,62,0,1,0,1,0
56234,445,0,0,drop,70,70,0,1,0,1,0
49903,53,18446,53,allow,215,102,113,2,29,1,1
50211,53,50211,53,allow,217,90,127,2,29,1,1
29697,51221,0,0,deny,62,62,0,1,0,1,0
50550,5228,24310,5228,allow,2661,1518,1143,18,3600,9,9
49218,443,54857,443,allow,590577,16239,574338,610,23,222,388
51585,80,50569,80,allow,3192,624,2568,10,155,5,5
55182,53,36739,53,allow,293,94,199,2,30,1,1
56993,80,53078,80,allow,214,140,74,4,35,3,1
63957,53,57529,53,allow,211,102,109,2,30,1,1
49938,57470,0,0,deny,66,66,0,1,0,1,0
49681,443,29652,443,allow,7074,2016,5058,26,187,13,13
55620,20795,23864,20795,allow,70,70,0,2,8,2,0
42030,25,0,0,deny,74,74,0,1,0,1,0
43308,443,4843,443,allow,120,120,0,2,5,2,0
50210,80,7597,80,allow,1277,460,817,16,71,5,11
50441,445,0,0,drop,66,66,0,1,0,1,0
61572,53,61572,53,allow,213,79,134,2,33,1,1
39422,443,26393,443,allow,557795,16003,541792,528,76,139,389
52716,443,35091,443,allow,69951,4941,65010,95,351,45,50
33060,443,63569,443,allow,25617,6531,19086,87,220,46,41
44414,123,11306,123,allow,184,94,90,2,30,1,1
49567,53,36957,53,allow,184,102,82,2,29,1,1
55598,445,0,0,drop,70,70,0,1,0,1,0
47739,53,26929,53,allow,168,78,90,2,29,1,1
50343,80,49722,80,allow,22233,10123,12110,37,28,16,21
56579,445,0,0,drop,66,66,0,1,0,1,0
65130,53,36063,53,allow,266,110,156,2,30,1,1
55262,44847,0,0,deny,62,62,0,1,0,1,0
63930,53,2970,53,allow,377,94,283,2,29,1,1
40356,9192,0,0,deny,145,145,0,1,0,1,0
49205,443,49232,443,allow,512444,20822,491622,555,159,191,364
55461,53,48907,53,allow,198,110,88,2,31,1,1
49319,53,9038,53,allow,199,102,97,2,30,1,1
56399,53,36148,53,allow,498,204,294,6,29,3,3
47902,443,46766,443,allow,2420,1462,958,18,170,10,8
46670,51505,0,0,deny,146,146,0,1,0,1,0
59733,445,0,0,drop,70,70,0,1,0,1,0
15503,55878,37795,55878,allow,481,150,331,2,1200,1,1
49160,33586,34033,33586,allow,1377,300,1077,6,1200,3,3
49296,443,51414,443,allow,7419,2173,5246,17,16,9,8
49647,80,48193,80,allow,318,192,126,6,42,4,2
64124,25174,0,0,deny,146,146,0,1,0,1,0
50010,445,0,0,drop,70,70,0,1,0,1,0
53240,443,24615,443,allow,46348,20067,26281,75,60,37,38
34885,443,20315,443,allow,80828,20592,60236,124,180,54,70
56961,445,0,0,drop,66,66,0,1,0,1,0
49847,23,0,0,deny,60,60,0,1,0,1,0
35486,443,63942,443,allow,4630,2803,1827,29,80,14,15
38637,22,0,0,deny,60,60,0,1,0,1,0
53233,51221,0,0,deny,66,66,0,1,0,1,0
37896,443,37896,443,allow,4704,1797,2907,19,30,11,8
56067,53,40948,53,allow,195,102,93,2,30,1,1
57019,53,54333,53,allow,193,102,91,2,30,1,1
53351,445,0,0,drop,66,66,0,1,0,1,0
50347,443,6764,443,allow,1385,868,517,12,30,6,6
51429,22114,0,0,deny,66,66,0,1,0,1,0
61660,64097,0,0,deny,62,62,0,1,0,1,0
55770,53,17489,53,allow,167,86,81,2,30,1,1
44687,443,14376,443,allow,3054,1741,1313,20,27,8,12
42231,57470,0,0,deny,78,78,0,1,0,1,0
43537,2323,0,0,deny,60,60,0,1,0,1,0
61919,445,0,0,drop,70,70,0,1,0,1,0
47213,443,42653,443,allow,8166,2498,5668,16,120,8,8
51148,443,35605,443,allow,4332,1907,2425,18,136,8,10
50652,445,0,0,drop,70,70,0,1,0,1,0
58630,445,0,0,drop,66,66,0,1,0,1,0
55111,39004,0,0,deny,66,66,0,1,0,1,0
50211,51050,0,0,deny,66,66,0,1,0,1,0
56442,11392,0,0,deny,66,66,0,1,0,1,0
31201,53,38511,53,allow,197,78,119,2,30,1,1
50142,443,40604,443,allow,9040,2349,6691,22,64,13,9
51893,445,0,0,drop,66,66,0,1,0,1,0
61074,445,0,0,drop,70,70,0,1,0,1,0
64205,445,0,0,drop,70,70,0,1,0,1,0
50895,80,56986,80,allow,9046,1139,7907,20,255,11,9
49344,53,20668,53,allow,458,188,270,6,29,3,3
57234,21247,0,0,deny,66,66,0,1,0,1,0
50116,22,50116,22,allow,60,60,0,1,5,1,0
65386,445,0,0,drop,70,70,0,1,0,1,0
62013,445,0,0,drop,66,66,0,1,0,1,0
58638,5900,0,0,deny,62,62,0,1,0,1,0
59523,37965,0,0,deny,62,62,0,1,0,1,0
53282,443,19856,443,allow,13300,1695,11605,27,321,12,15
63324,445,0,0,drop,70,70,0,1,0,1,0
58074,11392,0,0,deny,66,66,0,1,0,1,0
31410,25174,0,0,deny,146,146,0,1,0,1,0
50302,80,5947,80,allow,5100,1620,3480,17,114,10,7
48978,443,3498,443,allow,10163,3585,6578,47,26,24,23
58638,5900,0,0,deny,62,62,0,1,0,1,0
65286,53,2453,53,allow,369,102,267,2,30,1,1
49182,21247,0,0,deny,66,66,0,1,0,1,0
55994,53,19158,53,allow,182,93,89,2,31,1,1
57470,13551,21268,13551,allow,761,166,595,2,1200,1,1
42332,22114,0,0,deny,66,66,0,1,0,1,0
30181,61689,0,0,deny,62,62,0,1,0,1,0
49666,80,13546,80,allow,7270,3119,4151,14,41,7,7
54348,443,31489,443,allow,27760,9709,18051,56,45,27,29
62265,445,0,0,drop,70,70,0,1,0,1,0
56969,53,53086,53,allow,196,94,102,2,29,1,1
57385,443,20044,443,allow,8747,3323,5424,45,110,25,20
48982,15000,10476,15000,allow,130,70,60,2,5,1,1
64538,53,57273,53,allow,194,102,92,2,30,1,1
52522,445,0,0,drop,70,70,0,1,0,1,0
61145,445,0,0,drop,70,70,0,1,0,1,0
58638,5900,0,0,deny,62,62,0,1,0,1,0
39994,80,41282,80,allow,2387,930,1457,14,16,7,7
54011,44847,0,0,deny,66,66,0,1,0,1,0
53142,445,0,0,drop,70,70,0,1,0,1,0
52647,443,40426,443,allow,46502,33690,12812,93,234,55,38
27005,37579,44292,37579,allow,886,126,760,2,30,1,1
55285,53,18984,53,allow,268,95,173,4,46,2,2
45941,23388,0,0,deny,60,60,0,1,0,1,0
57348,25174,0,0,deny,62,62,0,1,0,1,0
59527,445,0,0,drop,66,66,0,1,0,1,0
49161,53,58186,53,allow,168,86,82,2,30,1,1
55856,53,9134,53,allow,1410,93,1317,4,59,2,2
53838,36829,0,0,deny,66,66,0,1,0,1,0
56594,53,29488,53,allow,167,86,81,2,30,1,1
52998,443,2559,443,allow,190,70,120,4,15,2,2
48676,53392,0,0,deny,60,60,0,1,0,1,0
63586,443,51785,443,allow,12760,2205,10555,39,122,21,18
65409,53,26325,53,allow,753,93,660,2,31,1,1
443,4512,0,0,deny,60,60,0,1,0,1,0
64733,53,63976,53,allow,889,404,485,10,30,5,5
55814,445,0,0,drop,70,70,0,1,0,1,0
52206,443,46301,443,allow,6278,682,5596,17,20,8,9
58699,445,0,0,drop,70,70,0,1,0,1,0
65191,445,0,0,drop,66,66,0,1,0,1,0
49594,22114,0,0,deny,66,66,0,1,0,1,0
59991,443,45209,443,allow,5108,2834,2274,21,143,10,11
64016,53,59779,53,allow,184,94,90,2,31,1,1
58239,445,0,0,drop,70,70,0,1,0,1,0
63934,53,32673,53,allow,209,110,99,2,29,1,1
54924,443,20791,443,allow,53816,22991,30825,139,306,71,68
64385,53,43683,53,allow,179,94,85,2,30,1,1
55271,53,6211,53,allow,168,86,82,2,30,1,1
60680,445,0,0,drop,70,70,0,1,0,1,0
64890,51180,0,0,deny,66,66,0,1,0,1,0
31619,51221,0,0,deny,62,62,0,1,0,1,0
10063,443,38761,443,allow,822903,35544,787359,1068,153,463,605
55752,53,35033,53,allow,170,87,83,2,31,1,1
55269,53,18249,53,allow,102,102,0,1,30,1,0
58398,445,0,0,drop,70,70,0,1,0,1,0
60478,443,17919,443,allow,5045,2009,3036,14,120,7,7
61770,445,0,0,drop,66,66,0,1,0,1,0
58338,3362,0,0,deny,60,60,0,1,0,1,0
52977,445,0,0,drop,70,70,0,1,0,1,0
63787,445,0,0,drop,70,70,0,1,0,1,0
49516,53,31257,53,allow,183,94,89,2,29,1,1
65353,53,60832,53,allow,170,87,83,2,30,1,1
53799,6881,35241,6881,allow,70,70,0,2,7,2,0
61140,445,0,0,drop,70,70,0,1,0,1,0
53287,445,0,0,drop,66,66,0,1,0,1,0
51773,445,0,0,drop,66,66,0,1,0,1,0
10306,44847,0,0,deny,62,62,0,1,0,1,0
55699,21063,52402,21063,allow,70,70,0,1,5,1,0
55714,445,0,0,drop,70,70,0,1,0,1,0
37716,443,28375,443,allow,14009,10561,3448,30,135,16,14
51754,1182,55646,1182,allow,70,70,0,2,7,2,0
57246,443,63215,443,allow,360050,17258,342792,432,68,185,247
64414,53,43076,53,allow,193,102,91,2,30,1,1
57563,443,58695,443,allow,10044,2134,7910,42,34,23,19
55176,53,63516,53,allow,190,97,93,2,31,1,1
58999,53,58999,53,allow,825,99,726,2,30,1,1
56622,80,24066,80,allow,234,234,0,4,12,4,0
49908,53,39258,53,allow,789,110,679,2,30,1,1
56737,53,36153,53,allow,817,98,719,2,31,1,1
59874,445,0,0,drop,66,66,0,1,0,1,0
59166,445,0,0,drop,70,70,0,1,0,1,0
37917,443,55165,443,allow,6124,860,5264,18,361,9,9
43666,443,10694,443,allow,13212,9431,3781,41,238,21,20
55336,53,26759,53,allow,199,102,97,2,31,1,1
12550,37807,0,0,deny,146,146,0,1,0,1,0
37179,443,24898,443,allow,7440,3165,4275,31,358,17,14
55593,53,39878,53,allow,288,288,0,4,47,4,0
53448,445,0,0,drop,70,70,0,1,0,1,0
45402,80,27119,80,allow,573,499,74,6,15,5,1
2740,22,0,0,deny,60,60,0,1,0,1,0
53126,47035,16520,47035,allow,70,70,0,2,8,2,0
65275,53,62237,53,allow,184,94,90,2,30,1,1
52158,80,31502,80,allow,502,310,192,9,31,6,3
54853,443,64447,443,allow,7689,3574,4115,65,308,32,33
65049,53,32515,53,allow,204,104,100,2,31,1,1
1025,35447,0,0,deny,62,62,0,1,0,1,0
37837,37965,0,0,deny,62,62,0,1,0,1,0
56726,443,54514,443,allow,4221,666,3555,13,15,7,6
53715,53,53715,53,allow,216,98,118,2,29,1,1
64813,53,49645,53,allow,177,94,83,2,30,1,1
51987,80,37675,80,allow,2175,1532,643,10,22,7,3
43916,21,0,0,deny,60,60,0,1,0,1,0
49653,443,56043,443,allow,8915,2193,6722,22,46,13,9
1165,53,1165,53,allow,196,88,108,2,30,1,1
42732,53,10027,53,allow,86,86,0,1,30,1,0
55704,64097,0,0,deny,66,66,0,1,0,1,0
12530,35440,0,0,deny,66,66,0,1,0,1,0
45214,443,34615,443,allow,6641,4617,2024,34,80,18,16
23807,44847,0,0,deny,66,66,0,1,0,1,0
57602,443,32129,443,allow,7527,1788,5739,23,20,13,10
63239,445,0,0,drop,70,70,0,1,0,1,0
8762,53,8762,53,allow,233,91,142,2,31,1,1
56712,53,17239,53,allow,177,94,83,2,30,1,1
50556,80,38454,80,allow,378,192,186,7,26,4,3
62348,50584,0,0,deny,62,62,0,1,0,1,0
64682,445,0,0,drop,66,66,0,1,0,1,0
51182,445,0,0,drop,66,66,0,1,0,1,0
58311,445,0,0,drop,70,70,0,1,0,1,0
443,60496,0,0,deny,320,320,0,1,0,1,0
37597,443,2780,443,allow,10497,3476,7021,34,17,18,16
49671,53,47128,53,allow,183,94,89,2,30,1,1
35201,443,64123,443,allow,291,171,120,4,15,2,2
58007,445,0,0,drop,66,66,0,1,0,1,0
56394,443,3047,443,allow,5019,946,4073,19,34,9,10
12694,12446,0,0,deny,62,62,0,1,0,1,0
64493,53,17644,53,allow,280,97,183,4,60,2,2
48629,63131,0,0,deny,74,74,0,1,0,1,0
1025,64147,0,0,deny,62,62,0,1,0,1,0
47325,2323,0,0,deny,60,60,0,1,0,1,0
57113,53,7922,53,allow,215,102,113,2,30,1,1
65012,2767,0,0,deny,66,66,0,1,0,1,0
53394,53,24735,53,allow,86,86,0,1,30,1,0
51353,445,0,0,drop,70,70,0,1,0,1,0
55728,445,0,0,drop,66,66,0,1,0,1,0
51815,51221,0,0,deny,74,74,0,1,0,1,0
50164,445,0,0,drop,70,70,0,1,0,1,0
12299,53,12299,53,allow,229,89,140,2,30,1,1
50804,443,11310,443,allow,6337,1378,4959,19,140,9,10
64942,53,36365,53,allow,284,102,182,4,38,2,2
52690,445,0,0,drop,66,66,0,1,0,1,0
65220,53,55029,53,allow,178,94,84,2,30,1,1
60557,23117,0,0,deny,66,66,0,1,0,1,0
49512,443,49512,443,allow,217225,47956,169269,284,64,149,135
49456,53,42586,53,allow,199,102,97,2,31,1,1
49394,443,39992,443,allow,6211,1869,4342,18,181,8,10
62331,445,0,0,drop,66,66,0,1,0,1,0
57088,445,0,0,drop,70,70,0,1,0,1,0
64403,53,60359,53,allow,198,101,97,2,30,1,1
49699,64147,0,0,deny,66,66,0,1,0,1,0
50130,53,58704,53,allow,183,94,89,2,29,1,1
61388,445,0,0,drop,66,66,0,1,0,1,0
49825,445,0,0,drop,66,66,0,1,0,1,0
48817,51414,48817,51414,allow,150,150,0,1,1200,1,0
39114,443,44592,443,allow,1238821,42695,1196126,1389,72,535,854
37574,443,27983,443,allow,499,425,74,4,0,3,1
55865,445,0,0,drop,66,66,0,1,0,1,0
49681,53,1706,53,allow,170,87,83,2,30,1,1
49346,53,23031,53,allow,228,110,118,2,30,1,1
52534,445,0,0,drop,70,70,0,1,0,1,0
64782,53,40065,53,allow,758,93,665,2,31,1,1
49964,53,9082,53,allow,760,97,663,2,30,1,1
55815,443,3642,443,allow,8602,1050,7552,16,120,7,9
10669,49756,0,0,deny,60,60,0,1,0,1,0
51948,445,0,0,drop,70,70,0,1,0,1,0
49655,80,40166,80,allow,499,192,307,6,42,4,2
49969,53,53673,53,allow,789,102,687,2,30,1,1
58832,443,61522,443,allow,274798,9459,265339,343,201,136,207
57030,53,58226,53,allow,283,101,182,4,38,2,2
39569,443,5001,443,allow,1784075,46752,1737323,1812,47,606,1206
55487,445,0,0,drop,70,70,0,1,0,1,0
60204,80,20326,80,allow,70,70,0,2,8,2,0
55962,53,7744,53,allow,193,102,91,2,30,1,1
55898,53,25351,53,allow,757,102,655,2,30,1,1
59592,37965,0,0,deny,62,62,0,1,0,1,0
55190,53,7214,53,allow,733,86,647,2,31,1,1
57341,53,25205,53,allow,184,94,90,2,30,1,1
43475,443,10490,443,allow,5578,1646,3932,23,16,13,10
65042,53,25956,53,allow,182,93,89,2,31,1,1
65189,27241,23433,27241,allow,235,71,164,2,31,1,1
55624,53,14345,53,allow,198,101,97,2,31,1,1
19632,37965,0,0,deny,62,62,0,1,0,1,0
49633,80,21073,80,allow,318,192,126,6,41,4,2
49703,80,27292,80,allow,71256,962,70294,63,52,11,52
56425,80,34044,80,allow,17188,1559,15629,25,31,10,15
62380,445,0,0,drop,70,70,0,1,0,1,0
49872,53,36268,53,allow,331,126,205,2,30,1,1
65220,445,0,0,drop,70,70,0,1,0,1,0
53159,445,0,0,drop,66,66,0,1,0,1,0
51328,443,46063,443,allow,6021,1981,4040,21,15,9,12
60776,445,0,0,drop,70,70,0,1,0,1,0
63289,445,0,0,drop,70,70,0,1,0,1,0
59736,51505,0,0,deny,62,62,0,1,0,1,0
47034,443,4001,443,allow,4531,3268,1263,23,27,13,10
50863,445,0,0,drop,66,66,0,1,0,1,0
20389,64147,0,0,deny,62,62,0,1,0,1,0
57239,5228,64844,5228,allow,16135,7514,8621,173,9115,72,101
49160,63307,39518,63307,allow,854,150,704,4,1200,2,2
49901,53,54026,53,allow,776,102,674,2,30,1,1
50126,443,34426,443,allow,15032,5689,9343,51,35,27,24
50928,443,1946,443,allow,3347,2025,1322,31,34,18,13
40492,1488,40492,1488,allow,156,156,0,3,8,3,0
52847,445,0,0,drop,70,70,0,1,0,1,0
59745,25174,0,0,deny,146,146,0,1,0,1,0
55465,443,38707,443,allow,12399,3942,8457,83,615,42,41
55659,37787,37419,37787,allow,70,70,0,1,5,1,0
57780,53,53500,53,allow,70,70,0,1,30,1,0
57788,443,31761,443,allow,6400,1327,5073,21,21,13,8
64428,53,56066,53,allow,195,102,93,2,30,1,1
49690,443,64449,443,allow,9107,2174,6933,29,187,14,15
49862,53,40662,53,allow,180,94,86,2,30,1,1
56374,53,38425,53,allow,770,102,668,2,31,1,1
36579,30188,0,0,deny,66,66,0,1,0,1,0
28973,30188,0,0,deny,66,66,0,1,0,1,0
24062,51505,0,0,deny,146,146,0,1,0,1,0
54393,445,0,0,drop,70,70,0,1,0,1,0
58162,445,0,0,drop,70,70,0,1,0,1,0
57632,7302,0,0,deny,146,146,0,1,0,1,0
43461,35440,0,0,deny,62,62,0,1,0,1,0
49881,443,45580,443,allow,5997,978,5019,19,53,10,9
2704,37,0,0,deny,60,60,0,1,0,1,0
49497,443,34229,443,allow,185560,47806,137754,421,295,217,204
55686,445,0,0,drop,70,70,0,1,0,1,0
65315,53,25931,53,allow,770,101,669,2,30,1,1
52099,28401,35047,28401,allow,70,70,0,1,5,1,0
49269,53,5251,53,allow,198,110,88,2,29,1,1
37308,43890,0,0,deny,62,62,0,1,0,1,0
55198,80,49692,80,allow,41822,2038,39784,56,15,27,29
60269,443,14941,443,allow,499,425,74,4,0,3,1
43357,443,59688,443,allow,1053,566,487,10,15,6,4
64860,445,0,0,drop,70,70,0,1,0,1,0
53539,44847,0,0,deny,66,66,0,1,0,1,0
58638,5900,0,0,deny,62,62,0,1,0,1,0
40273,53,38821,53,allow,164,78,86,2,30,1,1
54631,44847,0,0,deny,74,74,0,1,0,1,0
50632,443,47511,443,allow,4158,1021,3137,15,26,8,7
59000,443,41990,443,allow,9876,5325,4551,25,131,14,11
64755,31573,0,0,deny,62,62,0,1,0,1,0
55487,445,0,0,drop,70,70,0,1,0,1,0
443,4205,0,0,deny,320,320,0,1,0,1,0
57397,53,60967,53,allow,177,94,83,2,30,1,1
61923,80,14146,80,allow,4295,719,3576,16,125,8,8
65261,53,34538,53,allow,168,86,82,2,30,1,1
33227,443,20860,443,allow,8888,1757,7131,26,174,15,11
51747,7000,51747,7000,allow,3132,815,2317,14,15,7,7
57153,445,0,0,drop,66,66,0,1,0,1,0
57996,445,0,0,drop,70,70,0,1,0,1,0
55271,53,11910,53,allow,754,94,660,2,30,1,1
33013,443,50966,443,allow,88895,4807,84088,104,136,37,67
65234,53,35438,53,allow,193,102,91,2,30,1,1
56796,443,60351,443,allow,8074,2054,6020,20,15,11,9
55311,53,38927,53,allow,298,101,197,4,31,2,2
49512,53,60222,53,allow,195,102,93,2,31,1,1
1238,51505,0,0,deny,146,146,0,1,0,1,0
34478,443,59065,443,allow,9107,2253,6854,22,185,11,11
56828,53156,57681,53156,allow,70,70,0,2,8,2,0
26651,25174,0,0,deny,62,62,0,1,0,1,0
51107,80,61498,80,allow,366,240,126,7,21,5,2
64877,37450,0,0,deny,66,66,0,1,0,1,0
64837,53,39780,53,allow,195,102,93,2,30,1,1
49651,37965,0,0,deny,74,74,0,1,0,1,0
38000,443,20816,443,allow,13123,6654,6469,29,135,15,14
11821,64147,0,0,deny,62,62,0,1,0,1,0
3212,22114,0,0,deny,62,62,0,1,0,1,0
60593,445,0,0,drop,66,66,0,1,0,1,0
64587,53,36595,53,allow,167,86,81,2,31,1,1
57689,445,0,0,drop,70,70,0,1,0,1,0
64904,53,63887,53,allow,199,102,97,2,30,1,1
63954,60430,37652,60430,allow,70,70,0,1,4,1,0
61545,445,0,0,drop,70,70,0,1,0,1,0
54950,445,0,0,drop,70,70,0,1,0,1,0
52080,80,40918,80,allow,27100,21684,5416,39,38,25,14
62120,443,62120,443,allow,4378,1471,2907,19,27,11,8
55651,445,0,0,drop,70,70,0,1,0,1,0
50635,80,60349,80,allow,3722,1504,2218,13,20,7,6
55590,443,56220,443,allow,7906,1569,6337,20,150,9,11
65218,53,47163,53,allow,276,126,150,2,30,1,1
56135,53,22804,53,allow,542,112,430,4,34,2,2
45682,37965,0,0,deny,62,62,0,1,0,1,0
56414,80,4969,80,allow,33712,928,32784,36,104,11,25
51238,445,0,0,drop,70,70,0,1,0,1,0
36101,53,61383,53,allow,168,78,90,2,30,1,1
3410,17372,0,0,deny,62,62,0,1,0,1,0
1024,64147,0,0,deny,62,62,0,1,0,1,0
52812,25174,0,0,deny,62,62,0,1,0,1,0
58477,445,0,0,drop,70,70,0,1,0,1,0
64987,445,0,0,drop,70,70,0,1,0,1,0
43176,53,34266,53,allow,168,78,90,2,30,1,1
54560,445,0,0,drop,70,70,0,1,0,1,0
53373,64147,0,0,deny,66,66,0,1,0,1,0
52424,443,16403,443,allow,10070,5084,4986,41,16,24,17
57993,443,27022,443,allow,8647,1990,6657,23,26,14,9
59982,443,10585,443,allow,3640,870,2770,13,120,6,7
55384,53,33566,53,allow,212,102,110,2,30,1,1
16387,7205,0,0,deny,60,60,0,1,0,1,0
49759,53,54195,53,allow,164,84,80,2,31,1,1
57504,44847,0,0,deny,66,66,0,1,0,1,0
55656,53,37585,53,allow,214,110,104,2,30,1,1
60114,445,0,0,drop,66,66,0,1,0,1,0
27988,40006,7041,40006,allow,148,86,62,2,30,1,1
53728,445,0,0,drop,70,70,0,1,0,1,0
42252,33306,0,0,deny,60,60,0,1,0,1,0
54346,443,54346,443,allow,4651,1744,2907,19,27,11,8
59618,46824,0,0,deny,66,66,0,1,0,1,0
59731,443,4869,443,allow,384,166,218,2,31,1,1
7532,53,7532,53,allow,228,90,138,2,31,1,1
57470,10154,49581,10154,allow,924,924,0,15,1200,15,0
45941,23386,0,0,deny,60,60,0,1,0,1,0
47823,443,63568,443,allow,9842,2224,7618,20,122,10,10
44823,53,0,0,allow,82,82,0,1,30,1,0
41473,443,44182,443,allow,4987881,144889,4842992,5257,85,1888,3369
63334,445,0,0,drop,70,70,0,1,0,1,0
35078,443,8054,443,allow,234,234,0,4,12,4,0
59754,80,41353,80,allow,1352,848,504,13,83,8,5
37647,36237,0,0,deny,66,66,0,1,0,1,0
52655,15503,0,0,deny,146,146,0,1,0,1,0
55376,445,0,0,drop,70,70,0,1,0,1,0
55647,53,47322,53,allow,711,87,624,2,30,1,1
64311,53,19538,53,allow,199,102,97,2,30,1,1
55271,53,11109,53,allow,168,86,82,2,31,1,1
51826,58925,47237,58925,allow,70,70,0,1,4,1,0
55265,53,19057,53,allow,740,93,647,2,31,1,1
64981,445,0,0,drop,70,70,0,1,0,1,0
53114,32975,63232,32975,allow,70,70,0,1,5,1,0
57072,53,19221,53,allow,195,102,93,2,30,1,1
50061,445,0,0,drop,70,70,0,1,0,1,0
59162,445,0,0,drop,66,66,0,1,0,1,0
60564,445,0,0,drop,66,66,0,1,0,1,0
5955,55160,0,0,deny,74,74,0,1,0,1,0
14656,36237,0,0,deny,62,62,0,1,0,1,0
58095,445,0,0,drop,70,70,0,1,0,1,0
61711,80,55600,80,allow,4448,2223,2225,18,49,10,8
50186,443,39007,443,allow,6440,1603,4837,23,361,11,12
49781,53,21515,53,allow,194,102,92,2,30,1,1
56278,52752,0,0,deny,62,62,0,1,0,1,0
42813,443,40546,443,allow,1241645,28525,1213120,1200,65,328,872
53851,23650,26484,23650,allow,320,140,180,6,5,3,3
64364,53,21283,53,allow,193,94,99,2,31,1,1
51730,33399,62466,33399,allow,70,70,0,2,8,2,0
62625,37965,0,0,deny,66,66,0,1,0,1,0
49542,80,57907,80,allow,1012,531,481,8,25,5,3
42820,443,41684,443,allow,8155,1999,6156,22,81,13,9
57373,445,0,0,drop,70,70,0,1,0,1,0
56288,53,49732,53,allow,183,94,89,2,31,1,1
59420,443,62141,443,allow,2854,1732,1122,16,15,8,8
56571,53,42202,53,allow,325,102,223,2,30,1,1
63039,443,48295,443,allow,448,166,282,2,29,1,1
29988,44847,0,0,deny,66,66,0,1,0,1,0
54196,11392,0,0,deny,66,66,0,1,0,1,0
46093,32661,0,0,deny,74,74,0,1,0,1,0
39617,50584,0,0,deny,62,62,0,1,0,1,0
45941,23386,0,0,deny,60,60,0,1,0,1,0
57010,53,20752,53,allow,198,101,97,2,30,1,1
52191,445,0,0,drop,70,70,0,1,0,1,0
57317,443,9547,443,allow,5614,733,4881,16,15,9,7
64846,445,0,0,drop,70,70,0,1,0,1,0
56201,445,0,0,drop,70,70,0,1,0,1,0
56385,445,0,0,drop,66,66,0,1,0,1,0
50148,53,50148,53,allow,198,90,108,2,29,1,1
65471,53,50193,53,allow,498,204,294,6,31,3,3
26900,27017,61520,27017,allow,422,164,258,6,31,3,3
35626,22114,0,0,deny,66,66,0,1,0,1,0
59209,25174,0,0,deny,66,66,0,1,0,1,0
11295,40040,53425,40040,allow,213,89,124,4,54,2,2
34360,25174,0,0,deny,66,66,0,1,0,1,0
48020,443,61756,443,allow,33481,5635,27846,73,287,32,41
27005,30000,59167,30000,allow,913,126,787,2,30,1,1
56942,53,10682,53,allow,177,94,83,2,31,1,1
45941,23386,0,0,deny,60,60,0,1,0,1,0
49331,53,64999,53,allow,180,92,88,2,31,1,1
52519,44847,0,0,deny,66,66,0,1,0,1,0
58633,445,0,0,drop,70,70,0,1,0,1,0
37606,443,47206,443,allow,6277,1868,4409,22,45,13,9
42611,443,22505,443,allow,5559,1639,3920,21,186,12,9
24812,44847,0,0,deny,146,146,0,1,0,1,0
52701,445,0,0,drop,70,70,0,1,0,1,0
49290,443,20906,443,allow,1629306,22920,1606386,1339,116,262,1077
61054,53,61054,53,allow,237,91,146,2,33,1,1
50069,53,27415,53,allow,179,94,85,2,30,1,1
34548,443,60764,443,allow,11549,3378,8171,33,196,16,17
60943,445,0,0,drop,70,70,0,1,0,1,0
64439,53,36419,53,allow,359,134,225,2,30,1,1
51701,24343,49961,24343,allow,70,70,0,1,5,1,0
41029,80,41029,80,allow,12386,2651,9735,24,126,12,12
51355,445,0,0,drop,70,70,0,1,0,1,0
63683,445,0,0,drop,66,66,0,1,0,1,0
50824,443,63186,443,allow,337727,11283,326444,367,208,126,241
48676,53395,0,0,deny,60,60,0,1,0,1,0
6652,25174,0,0,deny,62,62,0,1,0,1,0
57086,53,16252,53,allow,711,87,624,2,30,1,1
65181,445,0,0,drop,70,70,0,1,0,1,0
50807,445,0,0,drop,66,66,0,1,0,1,0
58638,5900,0,0,deny,62,62,0,1,0,1,0
48381,53,16694,53,allow,221,75,146,2,30,1,1
60793,40010,33213,40010,allow,316,136,180,6,6,3,3
58702,80,13752,80,allow,2424,529,1895,11,75,6,5
64320,53,46178,53,allow,199,102,97,2,30,1,1
57172,53,27478,53,allow,196,102,94,2,31,1,1
64967,53,44002,53,allow,751,102,649,2,30,1,1
54434,445,0,0,drop,70,70,0,1,0,1,0
55933,53,58575,53,allow,177,94,83,2,30,1,1
65075,53,3072,53,allow,278,100,178,4,31,2,2
55966,57866,0,0,deny,66,66,0,1,0,1,0
50995,445,0,0,drop,70,70,0,1,0,1,0
61520,23718,0,0,deny,66,66,0,1,0,1,0
49920,443,59929,443,allow,6489,2137,4352,28,143,14,14
42607,443,6741,443,allow,10221,3259,6962,36,120,18,18
42644,443,8391,443,allow,8384,2161,6223,24,255,12,12
60821,445,0,0,drop,66,66,0,1,0,1,0
63957,53,44993,53,allow,214,94,120,2,29,1,1
64208,53,37921,53,allow,194,94,100,2,29,1,1
43018,443,63361,443,allow,4664,962,3702,15,120,7,8
55064,445,0,0,drop,70,70,0,1,0,1,0
60603,445,0,0,drop,70,70,0,1,0,1,0
1100,27540,45452,27540,allow,132,70,62,2,31,1,1
53832,56005,63005,56005,allow,70,70,0,1,4,1,0
59796,23,0,0,deny,60,60,0,1,0,1,0
64598,53,18969,53,allow,222,94,128,2,29,1,1
65495,53,27520,53,allow,209,110,99,2,30,1,1
49198,53,53619,53,allow,308,118,190,2,30,1,1
60369,443,26606,443,allow,6052,1841,4211,21,82,10,11
38861,443,38861,443,allow,90303,5838,84465,140,103,68,72
17008,35440,0,0,deny,62,62,0,1,0,1,0
61448,443,1765,443,allow,6109,1902,4207,33,141,19,14
56489,53,43327,53,allow,212,110,102,2,30,1,1
22773,443,22773,443,allow,6993,960,6033,17,31,10,7
50442,25174,0,0,deny,62,62,0,1,0,1,0
47982,443,20773,443,allow,83558,8567,74991,180,171,92,88
56769,53,50586,53,allow,195,102,93,2,30,1,1
59844,80,25773,80,allow,397391,8624,388767,380,49,118,262
63035,443,64744,443,allow,1864,250,1614,8,120,4,4
443,9986,0,0,deny,152,152,0,1,0,1,0
49425,53,61081,53,allow,772,102,670,2,30,1,1
10049,5222,44592,5222,allow,6103,3081,3022,63,616,34,29
51871,23801,64442,23801,allow,316,136,180,6,6,3,3
56550,123,27975,123,allow,184,94,90,2,30,1,1
53806,37267,20623,37267,allow,70,70,0,1,4,1,0
47135,53,52086,53,allow,199,94,105,2,30,1,1
58248,445,0,0,drop,66,66,0,1,0,1,0
53916,445,0,0,drop,70,70,0,1,0,1,0
61093,445,0,0,drop,70,70,0,1,0,1,0
56464,53,12940,53,allow,170,87,83,2,31,1,1
6881,6881,0,0,deny,62,62,0,1,0,1,0
56655,443,40290,443,allow,8058,2038,6020,20,15,11,9
42190,53,42190,53,allow,639,86,553,2,31,1,1
59880,443,7834,443,allow,16776,7513,9263,42,47,24,18
56834,46513,28288,46513,allow,70,70,0,1,5,1,0
63945,53,52680,53,allow,216,110,106,2,31,1,1
65495,53,62386,53,allow,209,110,99,2,31,1,1
15875,50584,0,0,deny,62,62,0,1,0,1,0
54030,443,52354,443,allow,249900,26024,223876,450,167,183,267
44981,57470,0,0,deny,66,66,0,1,0,1,0
48743,443,24308,443,allow,26609,2444,24165,45,21,21,24
59711,445,0,0,drop,70,70,0,1,0,1,0
49629,53,36000,53,allow,196,100,96,2,31,1,1
49968,53,62146,53,allow,1412,94,1318,4,33,2,2
57440,53,28373,53,allow,199,102,97,2,30,1,1
40078,44847,0,0,deny,146,146,0,1,0,1,0
56862,445,0,0,drop,66,66,0,1,0,1,0
6889,65473,0,0,deny,143,143,0,1,0,1,0
50523,445,0,0,drop,70,70,0,1,0,1,0
65173,53,61112,53,allow,508,186,322,6,51,3,3
55282,53,18223,53,allow,771,101,670,2,31,1,1
57372,53,54871,53,allow,177,94,83,2,30,1,1
49152,53,51402,53,allow,206,105,101,2,31,1,1
18461,19473,0,0,deny,66,66,0,1,0,1,0
57917,44847,0,0,deny,66,66,0,1,0,1,0
51221,55497,56542,55497,allow,528,528,0,9,1200,9,0
65115,53,14088,53,allow,167,86,81,2,30,1,1
49838,53,8093,53,allow,182,93,89,2,31,1,1
57504,44847,0,0,deny,66,66,0,1,0,1,0
52386,445,0,0,drop,70,70,0,1,0,1,0
49460,53,64925,53,allow,458,188,270,6,30,3,3
60212,445,0,0,drop,70,70,0,1,0,1,0
58147,443,65421,443,allow,8365,2826,5539,27,693,15,12
55697,445,0,0,drop,70,70,0,1,0,1,0
56952,445,0,0,drop,70,70,0,1,0,1,0
59773,5900,0,0,deny,60,60,0,1,0,1,0
45211,443,19368,443,allow,1629,968,661,15,275,8,7
49967,53,41633,53,allow,186,95,91,2,31,1,1
52501,80,52501,80,allow,79714,5592,74122,102,23,45,57
33084,443,45325,443,allow,15474,4188,11286,14,139,4,10
55294,53,64912,53,allow,199,102,97,2,29,1,1
55087,53,1147,53,allow,183,94,89,2,31,1,1
56813,443,32005,443,allow,8021,2001,6020,20,16,11,9
58638,5900,0,0,deny,62,62,0,1,0,1,0
50593,80,24582,80,allow,2365,1068,1297,13,79,7,6
56190,445,0,0,drop,66,66,0,1,0,1,0
64455,445,0,0,drop,70,70,0,1,0,1,0
44404,443,27524,443,allow,9060,3523,5537,27,319,15,12
50589,53,14237,53,allow,786,110,676,2,30,1,1
49579,445,0,0,drop,70,70,0,1,0,1,0
57167,53,41895,53,allow,195,102,93,2,30,1,1
50305,53,38735,53,allow,209,110,99,2,30,1,1
45475,161,0,0,allow,41552,20621,20931,212,31,106,106
26900,27017,43852,27017,allow,422,164,258,6,29,3,3
57585,443,57585,443,allow,2504,1458,1046,21,87,10,11
55098,53,38857,53,allow,474,200,274,6,43,3,3
62888,53,0,0,allow,193,78,115,2,30,1,1
46261,80,62301,80,allow,3578,1673,1905,16,186,9,7
51222,445,0,0,drop,70,70,0,1,0,1,0
54666,445,0,0,drop,66,66,0,1,0,1,0
29884,25174,0,0,deny,62,62,0,1,0,1,0
55429,25174,0,0,deny,66,66,0,1,0,1,0
3074,64147,0,0,deny,62,62,0,1,0,1,0
51028,445,0,0,drop,70,70,0,1,0,1,0
55254,50584,0,0,deny,66,66,0,1,0,1,0
54091,445,0,0,drop,66,66,0,1,0,1,0
52849,443,32844,443,allow,7735,1260,6475,16,133,7,9
60280,445,0,0,drop,70,70,0,1,0,1,0
58468,37965,0,0,deny,66,66,0,1,0,1,0
37616,443,9088,443,allow,702409,17257,685152,698,32,233,465
59117,443,59117,443,allow,4659,1752,2907,19,30,11,8
64937,53,43310,53,allow,183,94,89,2,29,1,1
62029,22114,0,0,deny,66,66,0,1,0,1,0
64190,2767,0,0,deny,66,66,0,1,0,1,0
49936,53,17708,53,allow,168,94,74,2,30,1,1
59923,53,59923,53,allow,365,233,132,3,33,2,1
57829,443,7967,443,allow,981499,39775,941724,1109,291,439,670
40571,26467,0,0,deny,62,62,0,1,0,1,0
10371,53,10371,53,allow,404,259,145,3,33,2,1
59560,443,54712,443,allow,4038,1219,2819,22,135,9,13
64571,443,18253,443,allow,9155,2109,7046,27,31,15,12
62947,53,18275,53,allow,213,86,127,2,30,1,1
52120,80,3357,80,allow,366,240,126,7,26,5,2
49774,53,40062,53,allow,234,102,132,2,30,1,1
28998,53,28998,53,allow,220,90,130,2,30,1,1
56872,445,0,0,drop,70,70,0,1,0,1,0
59612,445,0,0,drop,70,70,0,1,0,1,0
55706,53,9851,53,allow,258,102,156,2,30,1,1
49672,53,36807,53,allow,718,94,624,2,30,1,1
33973,50265,0,0,deny,62,62,0,1,0,1,0
56637,53,47556,53,allow,214,110,104,2,31,1,1
64082,53,17005,53,allow,356,97,259,4,58,2,2
60719,443,32077,443,allow,71523,19991,51532,112,41,59,53
64670,53,61851,53,allow,193,102,91,2,29,1,1
5688,44847,0,0,deny,66,66,0,1,0,1,0
54251,443,43085,443,allow,499,425,74,4,0,3,1
9997,53,9997,53,allow,235,90,145,2,32,1,1
27018,61508,0,0,deny,753,753,0,1,0,1,0
64898,53,12662,53,allow,487,201,286,6,42,3,3
61477,57470,0,0,deny,66,66,0,1,0,1,0
60794,443,17248,443,allow,796772,27151,769621,878,137,302,576
49755,443,49571,443,allow,447301,17016,430285,539,128,196,343
49730,53,46996,53,allow,211,110,101,2,30,1,1
49497,445,0,0,drop,70,70,0,1,0,1,0
0,0,0,0,deny,60,60,0,1,0,1,0
39916,53,62317,53,allow,168,78,90,2,30,1,1
49771,53,28192,53,allow,177,94,83,2,29,1,1
45813,5222,28803,5222,allow,5723,3023,2700,58,548,32,26
60965,443,57735,443,allow,1439,718,721,15,111,8,7
50896,80,56677,80,allow,11459959,142694,11317265,9719,135,1994,7725
64789,53,40256,53,allow,193,102,91,2,30,1,1
56629,25174,0,0,deny,66,66,0,1,0,1,0
49317,53,41699,53,allow,168,78,90,2,30,1,1
54109,36829,0,0,deny,62,62,0,1,0,1,0
54815,3389,54815,3389,allow,3424,1710,1714,16,31,8,8
65058,445,0,0,drop,70,70,0,1,0,1,0
53917,35885,37941,35885,allow,70,70,0,1,4,1,0
65229,53,50271,53,allow,195,102,93,2,30,1,1
53721,62413,0,0,deny,62,62,0,1,0,1,0
49449,80,5830,80,allow,1948,912,1036,13,56,7,6
64882,445,0,0,drop,66,66,0,1,0,1,0
56768,445,0,0,drop,66,66,0,1,0,1,0
48706,23393,0,0,deny,60,60,0,1,0,1,0
49662,443,55920,443,allow,9534,4029,5505,22,59,12,10
52912,443,9289,443,allow,41094,14929,26165,126,116,69,57
53873,52055,21698,52055,allow,70,70,0,2,8,2,0
58638,5900,0,0,deny,62,62,0,1,0,1,0
1749,64147,0,0,deny,66,66,0,1,0,1,0
55711,53,2553,53,allow,728,96,632,2,30,1,1
61875,445,0,0,drop,70,70,0,1,0,1,0
64772,64147,0,0,deny,62,62,0,1,0,1,0
52065,52021,23578,52021,allow,70,70,0,1,4,1,0
56047,445,0,0,drop,70,70,0,1,0,1,0
64950,53,51754,53,allow,728,102,626,2,30,1,1
52203,1024,52908,1024,allow,136,136,0,3,14,3,0
50182,443,50182,443,allow,12509,1447,11062,28,122,16,12
53332,443,6381,443,allow,23215,18990,4225,44,405,24,20
52944,443,11890,443,allow,58499,47163,11336,106,115,59,47
55006,443,44050,443,allow,2900,2007,893,20,36,12,8
59944,80,15920,80,allow,1052,612,440,10,15,5,5
49177,53,53466,53,allow,735,88,647,2,30,1,1
52148,443,33858,443,allow,375357,11451,363906,356,61,100,256
41677,57470,0,0,deny,66,66,0,1,0,1,0
15296,37965,0,0,deny,66,66,0,1,0,1,0
10013,40024,56811,40024,allow,156,94,62,2,30,1,1
52098,29067,64917,29067,allow,70,70,0,1,5,1,0
53019,80,53019,80,allow,181759,5146,176613,216,25,77,139
49382,53,52485,53,allow,200,102,98,2,31,1,1
63984,445,0,0,drop,70,70,0,1,0,1,0
52339,445,0,0,drop,70,70,0,1,0,1,0
50837,445,0,0,drop,66,66,0,1,0,1,0
51873,19311,22096,19311,allow,70,70,0,1,5,1,0
65499,53,38166,53,allow,166,86,80,2,29,1,1
35628,443,46062,443,allow,8414,4131,4283,36,64,16,20
52036,5900,0,0,deny,60,60,0,1,0,1,0
65152,53,32824,53,allow,167,86,81,2,31,1,1
63846,80,10554,80,allow,314,192,122,6,15,4,2
32955,80,30230,80,allow,14961,937,14024,25,16,11,14
58497,445,0,0,drop,70,70,0,1,0,1,0
53575,1025,56604,1025,allow,70,70,0,2,8,2,0
37551,443,6245,443,allow,9381,2351,7030,26,37,15,11
60770,443,16135,443,allow,4239,2026,2213,15,120,7,8
28305,25773,0,0,reset-both,148,148,0,1,0,1,0
55682,32765,50295,32765,allow,3529,1769,1760,11,15,6,5
64531,53,41084,53,allow,183,94,89,2,30,1,1
55806,53,52811,53,allow,200,102,98,2,33,1,1
38524,443,15396,443,allow,5846879,177697,5669182,6043,41,2261,3782
62068,64147,0,0,deny,66,66,0,1,0,1,0
14430,443,35759,443,allow,2629,1470,1159,18,15,8,10
57342,53,37406,53,allow,166,85,81,2,31,1,1
61278,56205,0,0,deny,66,66,0,1,0,1,0
27005,12345,54236,12345,allow,898,126,772,2,30,1,1
55765,443,54125,443,allow,4660,1915,2745,23,120,12,11
61916,64097,0,0,deny,66,66,0,1,0,1,0
14489,25174,0,0,deny,146,146,0,1,0,1,0
59899,53,59899,53,allow,194,87,107,2,31,1,1
57545,445,0,0,drop,66,66,0,1,0,1,0
52766,445,0,0,drop,66,66,0,1,0,1,0
49578,443,49511,443,allow,6947,833,6114,20,54,9,11
65266,53,21692,53,allow,216,110,106,2,30,1,1
51933,80,40922,80,allow,3676,2136,1540,15,40,10,5
10000,10214,0,0,deny,62,62,0,1,0,1,0
56912,53,43272,53,allow,216,94,122,2,30,1,1
61229,53,16392,53,allow,261,261,0,4,47,4,0
59865,443,51225,443,allow,502,250,252,9,26,5,4
49224,53,51489,53,allow,199,102,97,2,34,1,1
55848,445,0,0,drop,70,70,0,1,0,1,0
41165,443,56150,443,allow,8949,1938,7011,21,17,12,9
53157,445,0,0,drop,70,70,0,1,0,1,0
2531,30188,0,0,deny,62,62,0,1,0,1,0
52714,64147,0,0,deny,62,62,0,1,0,1,0
56176,53,42328,53,allow,194,102,92,2,30,1,1
64381,53,3642,53,allow,198,102,96,2,30,1,1
52280,995,52280,995,allow,142,78,64,2,5,1,1
53999,445,0,0,drop,70,70,0,1,0,1,0
55596,53,30266,53,allow,194,102,92,2,31,1,1
57290,53,13860,53,allow,178,94,84,2,30,1,1
60874,443,2065,443,allow,777438,37182,740256,940,64,407,533
49447,443,57996,443,allow,11281,5398,5883,21,125,11,10
55604,53,44456,53,allow,758,93,665,2,31,1,1
51291,25174,0,0,deny,62,62,0,1,0,1,0
57470,56432,6012,56432,allow,132,132,0,3,1199,3,0
49730,443,62541,443,allow,400810,14719,386091,506,39,164,342
52354,443,50559,443,allow,10417,5338,5079,22,135,11,11
29951,34021,0,0,reset-both,62,62,0,1,0,1,0
63765,445,0,0,drop,70,70,0,1,0,1,0
0,0,0,0,allow,320,320,0,5,0,5,0
53261,443,39643,443,allow,96485,4565,91920,119,150,45,74
59477,443,7119,443,allow,14489,12206,2283,25,120,15,10
60296,80,32377,80,allow,1463,865,598,11,144,6,5
49154,80,61897,80,allow,2438,565,1873,10,75,6,4
59970,443,20638,443,allow,7448,1347,6101,24,16,13,11
50594,80,12498,80,allow,1635,824,811,10,15,5,5
59772,62413,0,0,deny,66,66,0,1,0,1,0
2074,7010,2074,7010,allow,4279,2090,2189,16,15,8,8
38603,5228,52662,5228,allow,3534,1679,1855,30,3640,11,19
53727,53,60009,53,allow,172,72,100,2,30,1,1
64602,445,0,0,drop,66,66,0,1,0,1,0
57709,53,57709,53,allow,265,111,154,2,30,1,1
56959,80,53934,80,allow,15752,5736,10016,28,30,14,14
57039,445,0,0,drop,70,70,0,1,0,1,0
50371,443,40015,443,allow,456,390,66,4,0,3,1
43654,443,39718,443,allow,8761,2571,6190,24,17,14,10
443,44683,0,0,deny,83,83,0,1,0,1,0
58798,443,46435,443,allow,5167,700,4467,16,15,7,9
53951,445,0,0,drop,66,66,0,1,0,1,0
49730,53,40205,53,allow,194,102,92,2,30,1,1
55402,445,0,0,drop,70,70,0,1,0,1,0
53601,30160,62732,30160,allow,70,70,0,1,4,1,0
64929,53,46254,53,allow,168,86,82,2,31,1,1
50886,445,0,0,drop,66,66,0,1,0,1,0
52822,445,0,0,drop,70,70,0,1,0,1,0
60422,62456,45228,62456,allow,341,215,126,5,16,3,2
65219,53,39844,53,allow,410,99,311,4,56,2,2
49587,35776,0,0,deny,157,157,0,1,0,1,0
58638,5900,0,0,deny,62,62,0,1,0,1,0
28370,35440,0,0,deny,66,66,0,1,0,1,0
57340,53,2776,53,allow,216,110,106,2,30,1,1
53259,445,0,0,drop,70,70,0,1,0,1,0
27005,23333,15007,23333,allow,890,126,764,2,30,1,1
44718,80,25526,80,allow,4336,2408,1928,18,21,10,8
64908,53,50064,53,allow,812,110,702,2,30,1,1
52007,445,0,0,drop,66,66,0,1,0,1,0
59011,443,8442,443,allow,9619,6442,3177,33,122,15,18
64602,53,18957,53,allow,185,102,83,2,30,1,1
50052,65008,0,0,deny,60,60,0,1,0,1,0
64160,445,0,0,drop,66,66,0,1,0,1,0
64407,53,18646,53,allow,232,110,122,2,29,1,1
65061,53,31774,53,allow,299,103,196,4,33,2,2
45682,1,0,0,deny,62,62,0,1,0,1,0
49597,53,40368,53,allow,86,86,0,1,30,1,0
52695,443,43213,443,allow,34402,2328,32074,55,153,23,32
50771,80,8237,80,allow,6420,677,5743,13,151,6,7
49756,80,38066,80,allow,20926,3231,17695,37,51,17,20
30654,51221,0,0,deny,72,72,0,1,0,1,0
51315,445,0,0,drop,70,70,0,1,0,1,0
56265,445,0,0,drop,66,66,0,1,0,1,0
62469,445,0,0,drop,70,70,0,1,0,1,0
57290,53,48036,53,allow,758,93,665,2,30,1,1
49654,445,0,0,drop,66,66,0,1,0,1,0
4009,53,4009,53,allow,231,88,143,2,33,1,1
58638,5900,0,0,deny,62,62,0,1,0,1,0
18029,50584,0,0,deny,66,66,0,1,0,1,0
49257,445,0,0,drop,70,70,0,1,0,1,0
56748,445,0,0,drop,70,70,0,1,0,1,0
65196,53,56319,53,allow,172,94,78,2,29,1,1
22948,26467,0,0,deny,62,62,0,1,0,1,0
56563,443,19548,443,allow,4528,884,3644,15,26,9,6
53952,26973,12520,26973,allow,70,70,0,2,8,2,0
57258,445,0,0,drop,66,66,0,1,0,1,0
60168,35440,0,0,deny,66,66,0,1,0,1,0
63459,445,0,0,drop,70,70,0,1,0,1,0
54021,25174,0,0,deny,62,62,0,1,0,1,0
53002,80,19802,80,allow,1601,761,840,10,334,6,4
63811,443,59225,443,allow,25707,7559,18148,53,121,24,29
6882,40796,60379,40796,allow,228,118,110,2,1200,1,1
49984,53,11243,53,allow,373,88,285,4,58,2,2
64517,53,39078,53,allow,194,102,92,2,31,1,1
55774,53,26343,53,allow,701,88,613,2,30,1,1
61688,443,16509,443,allow,14462,3625,10837,31,63,16,15
49746,53,23888,53,allow,177,94,83,2,30,1,1
55817,36829,0,0,deny,66,66,0,1,0,1,0
52018,2425,15478,2425,allow,70,70,0,2,9,2,0
50828,443,8189,443,allow,178483,7778,170705,219,218,90,129
59876,44847,0,0,deny,62,62,0,1,0,1,0
63731,445,0,0,drop,70,70,0,1,0,1,0
55013,53,63318,53,allow,728,102,626,2,29,1,1
64577,443,50601,443,allow,24686,1935,22751,36,16,17,19
443,60496,0,0,deny,320,320,0,1,0,1,0
8802,80,39611,80,allow,4999,1313,3686,36,667,8,28
36579,30188,0,0,deny,66,66,0,1,0,1,0
56941,445,0,0,drop,70,70,0,1,0,1,0
10243,36237,0,0,deny,62,62,0,1,0,1,0
50056,27018,43222,27018,allow,468,390,78,5,29,4,1
56536,443,5996,443,allow,6044,3444,2600,49,501,25,24
443,35385,0,0,deny,130,130,0,1,0,1,0
54459,445,0,0,drop,66,66,0,1,0,1,0
56977,80,20065,80,allow,214,140,74,4,35,3,1
64870,53,51566,53,allow,200,102,98,2,30,1,1
54876,25174,0,0,deny,146,146,0,1,0,1,0
31748,56205,0,0,deny,146,146,0,1,0,1,0
51744,445,0,0,drop,70,70,0,1,0,1,0
50562,53,50562,53,allow,216,82,134,2,32,1,1
443,49689,0,0,deny,60,60,0,1,0,1,0
40054,62413,0,0,deny,62,62,0,1,0,1,0
38859,22114,0,0,deny,66,66,0,1,0,1,0
55984,445,0,0,drop,70,70,0,1,0,1,0
44293,443,16772,443,allow,5880,2280,3600,31,76,14,17
62348,30349,0,0,deny,148,148,0,1,0,1,0
50613,445,0,0,drop,70,70,0,1,0,1,0
49884,53,44954,53,allow,232,110,122,2,30,1,1
31019,53,31019,53,allow,194,87,107,2,30,1,1
55656,445,0,0,drop,70,70,0,1,0,1,0
64113,445,0,0,drop,70,70,0,1,0,1,0
42298,40039,50865,40039,allow,602,86,516,2,30,1,1
52358,30188,0,0,deny,66,66,0,1,0,1,0
9552,57470,0,0,deny,66,66,0,1,0,1,0
47613,53,0,0,allow,82,82,0,1,30,1,0
44847,6881,59803,6881,allow,484,150,334,2,1200,1,1
52041,48103,36252,48103,allow,70,70,0,2,8,2,0
55176,53,57165,53,allow,195,102,93,2,30,1,1
57601,445,0,0,drop,70,70,0,1,0,1,0
55691,443,55691,443,allow,165616,8760,156856,199,82,79,120
55912,53,11122,53,allow,199,102,97,2,30,1,1
55004,443,35617,443,allow,27629,9041,18588,88,271,46,42
65466,53,32995,53,allow,200,102,98,2,30,1,1
49542,445,0,0,drop,66,66,0,1,0,1,0
61072,445,0,0,drop,70,70,0,1,0,1,0
55045,445,0,0,drop,70,70,0,1,0,1,0
54653,53,54653,53,allow,231,90,141,2,30,1,1
50994,35974,0,0,deny,60,60,0,1,0,1,0
49806,443,11715,443,allow,37255,2202,35053,46,125,17,29
52057,80,6987,80,allow,422,240,182,8,25,5,3
63831,445,0,0,drop,70,70,0,1,0,1,0
60816,445,0,0,drop,70,70,0,1,0,1,0
64945,53,44242,53,allow,243,94,149,2,30,1,1
61722,445,0,0,drop,70,70,0,1,0,1,0
55048,443,61796,443,allow,12799,3662,9137,40,50,22,18
6355,25174,0,0,deny,62,62,0,1,0,1,0
49323,443,62942,443,allow,9802,2846,6956,33,79,15,18
59965,36237,0,0,deny,66,66,0,1,0,1,0
39446,443,32219,443,allow,1647482,62713,1584769,1898,219,744,1154
40375,443,13030,443,allow,130,70,60,3,5,2,1
50116,22,0,0,deny,60,60,0,1,0,1,0
56200,53,9546,53,allow,206,105,101,2,30,1,1
22408,22114,0,0,deny,66,66,0,1,0,1,0
38018,443,11782,443,allow,1851,1222,629,16,27,10,6
65477,53,50858,53,allow,209,110,99,2,30,1,1
47396,23,0,0,deny,60,60,0,1,0,1,0
57176,443,31036,443,allow,12844,2619,10225,23,120,10,13
57025,53,16250,53,allow,168,86,82,2,30,1,1
43642,48817,0,0,deny,134,134,0,1,0,1,0
43817,443,47281,443,allow,5911,1666,4245,27,18,15,12
1865,25174,0,0,deny,62,62,0,1,0,1,0
64913,53,27699,53,allow,182,93,89,2,31,1,1
49679,80,26556,80,allow,7256,1682,5574,14,40,6,8
56574,445,0,0,drop,70,70,0,1,0,1,0
61024,445,0,0,drop,66,66,0,1,0,1,0
42993,443,7986,443,allow,10692,4532,6160,31,134,16,15
64192,445,0,0,drop,66,66,0,1,0,1,0
57176,53,50437,53,allow,178,94,84,2,29,1,1
41857,443,32439,443,allow,1633,1010,623,14,2424,7,7
56406,53,15140,53,allow,213,102,111,2,30,1,1
49999,445,0,0,drop,70,70,0,1,0,1,0
52606,53,0,0,allow,223,91,132,2,30,1,1
55134,53,14594,53,allow,212,108,104,2,30,1,1
50408,445,0,0,drop,70,70,0,1,0,1,0
57053,53,14057,53,allow,173,94,79,2,29,1,1
65266,53,39575,53,allow,216,110,106,2,30,1,1
46477,443,29699,443,allow,4900,904,3996,16,97,9,7
50641,80,49164,80,allow,1658,1247,411,8,15,5,3
52076,445,0,0,drop,70,70,0,1,0,1,0
49207,443,35553,443,allow,9852,2190,7662,49,257,22,27
55068,53,59463,53,allow,196,102,94,2,29,1,1
55884,445,0,0,drop,66,66,0,1,0,1,0
60706,443,17990,443,allow,4974,836,4138,16,40,8,8
1117,37965,0,0,deny,62,62,0,1,0,1,0
51158,443,53566,443,allow,3155111,84086,3071025,3163,75,1072,2091
55216,53,63091,53,allow,174,89,85,2,30,1,1
49281,445,0,0,drop,66,66,0,1,0,1,0
49237,8080,49237,8080,allow,4451,1329,3122,13,53,7,6
49686,445,0,0,drop,70,70,0,1,0,1,0
50570,57470,0,0,deny,66,66,0,1,0,1,0
56160,53,39836,53,allow,195,102,93,2,30,1,1
50052,65008,0,0,deny,60,60,0,1,0,1,0
54210,64097,0,0,deny,66,66,0,1,0,1,0
6842,42873,0,0,deny,66,66,0,1,0,1,0
57308,443,38390,443,allow,36373,15248,21125,172,123,69,103
56919,53,19863,53,allow,186,95,91,2,31,1,1
58226,52848,0,0,deny,62,62,0,1,0,1,0
56183,445,0,0,drop,70,70,0,1,0,1,0
64934,53,52297,53,allow,197,102,95,2,33,1,1
35558,15503,0,0,deny,66,66,0,1,0,1,0
27005,27015,5485,27015,allow,889,126,763,2,30,1,1
49236,80,22987,80,allow,1904818,59945,1844873,1747,162,498,1249
56570,443,57405,443,allow,4722,1330,3392,18,80,9,9
49418,27015,34023,27015,allow,249,71,178,2,30,1,1
8910,62413,0,0,deny,146,146,0,1,0,1,0
0,0,0,0,deny,98,98,0,1,0,1,0
62108,445,0,0,drop,70,70,0,1,0,1,0
54786,30188,0,0,deny,66,66,0,1,0,1,0
61210,445,0,0,drop,66,66,0,1,0,1,0
55700,53,12317,53,allow,337,110,227,2,30,1,1
64792,53,47254,53,allow,166,86,80,2,30,1,1
56082,53,1185,53,allow,730,102,628,2,29,1,1
50584,51413,31560,51413,allow,800,150,650,4,1200,2,2
56748,80,11482,80,allow,946,531,415,11,296,6,5
55044,53,9273,53,allow,192,98,94,2,30,1,1
5826,26467,0,0,deny,62,62,0,1,0,1,0
41317,53,41317,53,allow,217,87,130,2,30,1,1
49969,445,0,0,drop,70,70,0,1,0,1,0
55605,53,56113,53,allow,196,100,96,2,30,1,1
55145,11392,0,0,deny,66,66,0,1,0,1,0
60222,22114,0,0,deny,66,66,0,1,0,1,0
55022,60100,63915,60100,allow,1550,1130,420,15,25,9,6
49450,53,42470,53,allow,330,118,212,2,30,1,1
53239,443,57625,443,allow,84664,6099,78565,140,70,56,84
49126,443,33194,443,allow,3800867,77753,3723114,3263,625,478,2785
9477,443,41654,443,allow,7461,1448,6013,22,35,11,11
49780,53,34638,53,allow,183,94,89,2,29,1,1
64559,53,43720,53,allow,168,86,82,2,30,1,1
6881,6881,34489,6881,allow,253,118,135,2,1199,1,1
54199,443,3753,443,allow,26903,3579,23324,72,278,33,39
43086,443,19069,443,allow,6496,2026,4470,20,16,12,8
60220,80,36816,80,allow,21108,15948,5160,47,151,30,17
62865,443,23097,443,allow,21313,7245,14068,48,128,22,26
57333,445,0,0,drop,66,66,0,1,0,1,0
10050,31573,0,0,deny,146,146,0,1,0,1,0
57201,53,46716,53,allow,214,110,104,2,30,1,1
2082,7000,2082,7000,allow,3022,1567,1455,16,15,8,8
61872,445,0,0,drop,70,70,0,1,0,1,0
36503,443,18047,443,allow,3549,899,2650,13,120,6,7
59694,50584,0,0,deny,62,62,0,1,0,1,0
62624,445,0,0,drop,70,70,0,1,0,1,0
64431,53,6973,53,allow,177,94,83,2,30,1,1
51413,54751,0,0,deny,136,136,0,1,0,1,0
44411,37965,0,0,deny,62,62,0,1,0,1,0
49881,445,0,0,drop,70,70,0,1,0,1,0
50698,5900,50698,5900,allow,130,66,64,2,5,1,1
55502,445,0,0,drop,70,70,0,1,0,1,0
64144,53,48969,53,allow,186,95,91,2,30,1,1
62304,445,0,0,drop,66,66,0,1,0,1,0
52479,443,9730,443,allow,11052,4417,6635,19,137,10,9
59400,443,43611,443,allow,6489,2731,3758,19,16,10,9
62103,445,0,0,drop,66,66,0,1,0,1,0
53651,47758,20351,47758,allow,70,70,0,2,7,2,0
54432,445,0,0,drop,66,66,0,1,0,1,0
51243,445,0,0,drop,70,70,0,1,0,1,0
58460,36237,0,0,deny,66,66,0,1,0,1,0
49485,56972,0,0,deny,66,66,0,1,0,1,0
56367,443,5869,443,allow,4863,3011,1852,20,234,12,8
53770,443,15341,443,allow,499,425,74,4,0,3,1
65439,53,2036,53,allow,168,86,82,2,29,1,1
1733,65448,0,0,deny,66,66,0,1,0,1,0
1860,25174,0,0,deny,66,66,0,1,0,1,0
59935,445,0,0,drop,70,70,0,1,0,1,0
55199,21247,0,0,deny,66,66,0,1,0,1,0
54071,445,0,0,drop,70,70,0,1,0,1,0
64825,445,0,0,drop,70,70,0,1,0,1,0
52272,37105,49502,37105,allow,316,136,180,6,6,3,3
43483,443,14734,443,allow,144138,17538,126600,275,300,115,160
55002,443,46892,443,allow,6953,2447,4506,26,37,15,11
50070,443,16090,443,allow,9148,1570,7578,31,257,13,18
56707,443,1984,443,allow,5928,1558,4370,22,20,13,9
63765,51221,0,0,deny,62,62,0,1,0,1,0
55067,53,2725,53,allow,164,84,80,2,31,1,1
50254,44847,0,0,deny,66,66,0,1,0,1,0
45941,23388,0,0,deny,60,60,0,1,0,1,0
49578,53,60840,53,allow,212,102,110,2,29,1,1
53994,16605,15809,16605,allow,70,70,0,2,8,2,0
50090,50265,0,0,deny,66,66,0,1,0,1,0
56642,443,26637,443,allow,27108,2396,24712,40,80,18,22
50179,443,33699,443,allow,5419,1080,4339,17,42,10,7
34658,80,20483,80,allow,6094,954,5140,15,3601,8,7
52318,443,6808,443,allow,9453,2797,6656,46,32,25,21
56704,53,33003,53,allow,711,87,624,2,30,1,1
45346,443,29212,443,allow,2438,1442,996,21,20,12,9
52726,445,0,0,drop,66,66,0,1,0,1,0
49718,53,42238,53,allow,807,94,713,2,30,1,1
50625,443,48490,443,allow,3090,1707,1383,15,19,9,6
64546,53,63352,53,allow,889,404,485,10,30,5,5
27005,29999,60743,29999,allow,887,126,761,2,31,1,1
49257,53,51437,53,allow,199,102,97,2,30,1,1
64609,53,7201,53,allow,168,86,82,2,30,1,1
53157,34841,3594,34841,allow,698,320,378,10,16,6,4
55770,53,28096,53,allow,167,86,81,2,29,1,1
56499,445,0,0,drop,66,66,0,1,0,1,0
53664,445,0,0,drop,66,66,0,1,0,1,0
50640,445,0,0,drop,70,70,0,1,0,1,0
58638,5900,0,0,deny,62,62,0,1,0,1,0
54231,445,0,0,drop,70,70,0,1,0,1,0
58318,15503,0,0,deny,66,66,0,1,0,1,0
62972,445,0,0,drop,70,70,0,1,0,1,0
45780,443,35080,443,allow,7847,1591,6256,23,186,13,10
55645,18904,52547,18904,allow,320,140,180,6,6,3,3
53758,443,30147,443,allow,499,425,74,4,0,3,1
60089,445,0,0,drop,70,70,0,1,0,1,0
59157,443,21885,443,allow,7139,3570,3569,22,166,11,11
35587,123,5043,123,allow,184,94,90,2,30,1,1
58638,5900,0,0,deny,62,62,0,1,0,1,0
46028,80,31228,80,allow,1176793,65077,1111716,1528,85,788,740
64416,53,53808,53,allow,211,94,117,2,30,1,1
57162,53,0,0,allow,198,91,107,2,30,1,1
55079,445,0,0,drop,70,70,0,1,0,1,0
3478,61463,0,0,deny,1345,1345,0,1,0,1,0
54101,443,19141,443,allow,4013,2840,1173,23,27,13,10
53746,445,0,0,drop,70,70,0,1,0,1,0
64680,445,0,0,drop,66,66,0,1,0,1,0
63488,22114,0,0,deny,62,62,0,1,0,1,0
56632,53,26751,53,allow,200,94,106,2,29,1,1
12458,161,0,0,deny,85,85,0,1,0,1,0
59177,53,0,0,allow,619,76,543,2,30,1,1
55194,53,43998,53,allow,195,102,93,2,30,1,1
52781,443,23345,443,allow,1581,924,657,15,125,7,8
27785,37965,0,0,deny,66,66,0,1,0,1,0
49488,53,49488,53,allow,823,98,725,2,30,1,1
65480,53,23239,53,allow,211,102,109,2,30,1,1
56232,445,0,0,drop,70,70,0,1,0,1,0
56732,443,23589,443,allow,7855,1866,5989,20,15,11,9
49762,53,30143,53,allow,819,102,717,2,29,1,1
53354,80,22791,80,allow,2722,1530,1192,12,316,7,5
55694,53,54062,53,allow,166,85,81,2,31,1,1
49370,11392,0,0,deny,66,66,0,1,0,1,0
56481,53,28182,53,allow,816,102,714,2,30,1,1
61291,445,0,0,drop,70,70,0,1,0,1,0
62076,443,11320,443,allow,7370,2873,4497,23,47,13,10
8889,53670,0,0,deny,60,60,0,1,0,1,0
49442,445,0,0,drop,66,66,0,1,0,1,0
49237,53,49766,53,allow,735,88,647,2,31,1,1
18683,26467,0,0,deny,62,62,0,1,0,1,0
58587,445,0,0,drop,70,70,0,1,0,1,0
59538,80,28530,80,allow,1895,755,1140,11,14,6,5
46760,50584,0,0,deny,146,146,0,1,0,1,0
23843,26467,0,0,deny,62,62,0,1,0,1,0
0,0,0,0,allow,244,244,0,2,0,2,0
56141,53,40551,53,allow,713,94,619,4,54,2,2
6881,6881,38378,6881,allow,231,111,120,2,1200,1,1
55614,53,42097,53,allow,309,110,199,2,30,1,1
49760,1443,52471,1443,allow,626,352,274,10,15,6,4
64790,53,41901,53,allow,178,94,84,2,29,1,1
58638,5900,0,0,deny,62,62,0,1,0,1,0
52075,445,0,0,drop,70,70,0,1,0,1,0
58710,445,0,0,drop,66,66,0,1,0,1,0
51834,445,0,0,drop,66,66,0,1,0,1,0
44236,80,40314,80,allow,2982,2565,417,12,15,7,5
1027,9822,0,0,deny,146,146,0,1,0,1,0
60993,443,45715,443,allow,7201,2107,5094,23,61,13,10
55080,53,5647,53,allow,330,86,244,2,30,1,1
55286,53,26564,53,allow,268,87,181,4,35,2,2
57235,53,60743,53,allow,757,102,655,2,29,1,1
61643,22114,0,0,deny,62,62,0,1,0,1,0
51804,31012,6657,31012,allow,70,70,0,2,8,2,0
65194,53,9315,53,allow,265,91,174,4,36,2,2
50524,53,62327,53,allow,193,102,91,2,30,1,1
17206,53,17206,53,allow,240,98,142,2,29,1,1
40967,1433,0,0,deny,60,60,0,1,0,1,0
62721,445,0,0,drop,70,70,0,1,0,1,0
6881,6881,1541,6881,allow,237,118,119,2,1200,1,1
57409,443,54706,443,allow,1054,567,487,10,15,6,4
64849,53,57025,53,allow,340,110,230,2,29,1,1
51804,53,51804,53,allow,247,98,149,2,33,1,1
50008,53,47667,53,allow,193,102,91,2,31,1,1
51726,64147,0,0,deny,66,66,0,1,0,1,0
49654,22,49654,22,allow,7791,3373,4418,54,36,26,28
54360,445,0,0,drop,70,70,0,1,0,1,0
1873,37965,0,0,deny,62,62,0,1,0,1,0
40768,443,17418,443,allow,3287,2049,1238,12,32,7,5
51773,80,63744,80,allow,40993,2984,38009,57,24,28,29
60429,46854,20959,46854,allow,70,70,0,1,5,1,0
49259,445,0,0,drop,70,70,0,1,0,1,0
54684,37965,0,0,deny,62,62,0,1,0,1,0
50728,443,61192,443,allow,34661,17810,16851,89,119,40,49
53645,445,0,0,drop,66,66,0,1,0,1,0
62189,64147,0,0,deny,62,62,0,1,0,1,0
59793,443,27595,443,allow,840,456,384,14,25,8,6
51776,14645,62934,14645,allow,70,70,0,1,5,1,0
56646,53,16936,53,allow,177,94,83,2,29,1,1
61223,37965,0,0,deny,66,66,0,1,0,1,0
26881,25174,0,0,deny,66,66,0,1,0,1,0
63824,445,0,0,drop,66,66,0,1,0,1,0
45964,2225,0,0,deny,60,60,0,1,0,1,0
51391,445,0,0,drop,70,70,0,1,0,1,0
55180,53,64280,53,allow,780,93,687,2,31,1,1
50547,22197,0,0,deny,66,66,0,1,0,1,0
63934,55027,48051,55027,allow,66,66,0,2,8,2,0
57470,22796,55699,22796,allow,2224,1852,372,33,1565,27,6
49640,445,0,0,drop,66,66,0,1,0,1,0
54578,26467,0,0,deny,66,66,0,1,0,1,0
55443,445,0,0,drop,70,70,0,1,0,1,0
59177,445,0,0,drop,70,70,0,1,0,1,0
58638,5900,58638,5900,allow,66,66,0,1,4,1,0
64166,35440,0,0,deny,62,62,0,1,0,1,0
55707,53,31512,53,allow,177,94,83,2,30,1,1
64407,53,28727,53,allow,291,94,197,2,30,1,1
57862,443,61289,443,allow,448344,11729,436615,474,157,128,346
52607,445,0,0,drop,70,70,0,1,0,1,0
63200,445,0,0,drop,66,66,0,1,0,1,0
36738,123,0,0,deny,234,234,0,1,0,1,0
2079,7000,2079,7000,allow,3102,1551,1551,16,16,8,8
50761,445,0,0,drop,70,70,0,1,0,1,0
65526,53,17627,53,allow,199,102,97,2,29,1,1
65419,443,11559,443,allow,2494,1643,851,17,24,9,8
60461,443,30128,443,allow,18515,2899,15616,32,148,15,17
17643,50584,0,0,deny,146,146,0,1,0,1,0
49827,443,4607,443,allow,21625,7638,13987,45,48,24,21
49953,80,9395,80,allow,11209,819,10390,19,15,9,10
49914,53,9646,53,allow,718,94,624,2,30,1,1
40204,40002,65519,40002,allow,148,86,62,2,30,1,1
53323,35253,0,0,deny,66,66,0,1,0,1,0
49656,445,0,0,drop,66,66,0,1,0,1,0
61733,443,10616,443,allow,168812,5693,163119,186,21,68,118
59068,49813,0,0,deny,74,74,0,1,0,1,0
53251,443,53251,443,allow,1404,697,707,17,121,8,9
50071,53,62204,53,allow,458,188,270,6,30,3,3
64613,53,26326,53,allow,89,89,0,1,30,1,0
58486,57470,0,0,deny,66,66,0,1,0,1,0
38602,443,28302,443,allow,130,70,60,3,5,2,1
51313,445,0,0,drop,66,66,0,1,0,1,0
55893,45711,0,0,deny,78,78,0,1,0,1,0
53672,445,0,0,drop,70,70,0,1,0,1,0
60324,445,0,0,drop,66,66,0,1,0,1,0
38011,443,55120,443,allow,6732,885,5847,24,368,7,17
58763,53,58763,53,allow,228,90,138,2,29,1,1
50230,445,0,0,drop,66,66,0,1,0,1,0
35271,443,35271,443,allow,134405,6968,127437,187,97,85,102
61964,443,61964,443,allow,4378,1471,2907,19,30,11,8
52458,53,52458,53,allow,231,88,143,2,33,1,1
49667,53,38974,53,allow,261,94,167,2,30,1,1
57201,53,44480,53,allow,165,86,79,2,30,1,1
49903,53,41942,53,allow,194,94,100,2,30,1,1
52248,443,56929,443,allow,190,70,120,4,15,2,2
56825,16648,32548,16648,allow,164,70,94,2,7,1,1
64055,445,0,0,drop,66,66,0,1,0,1,0
443,46223,0,0,deny,66,66,0,1,0,1,0
59417,443,49153,443,allow,2898,1700,1198,16,15,8,8
50566,445,0,0,drop,70,70,0,1,0,1,0
63062,53,6744,53,allow,303,85,218,2,30,1,1
61589,21247,0,0,deny,62,62,0,1,0,1,0
57314,53,61726,53,allow,190,97,93,2,31,1,1
57842,53,57842,53,allow,225,87,138,2,30,1,1
55552,53,60195,53,allow,211,102,109,2,30,1,1
55550,445,0,0,drop,70,70,0,1,0,1,0
45726,64147,0,0,deny,62,62,0,1,0,1,0
54758,35993,0,0,deny,62,62,0,1,0,1,0
44205,443,40929,443,allow,13019,4593,8426,71,350,34,37
49423,445,0,0,drop,70,70,0,1,0,1,0
55222,53,63142,53,allow,181,94,87,2,29,1,1
59748,53,55446,53,allow,230,110,120,2,29,1,1
55564,53,55564,53,allow,215,88,127,2,30,1,1
60695,445,0,0,drop,66,66,0,1,0,1,0
53759,80,20494,80,allow,997,582,415,11,315,6,5
53007,445,0,0,drop,70,70,0,1,0,1,0
47824,53,65037,53,allow,199,94,105,2,30,1,1
54759,445,0,0,drop,66,66,0,1,0,1,0
60645,35440,0,0,deny,66,66,0,1,0,1,0
16905,57866,0,0,deny,66,66,0,1,0,1,0
60906,443,59580,443,allow,11543,5375,6168,45,47,24,21
49272,53,2689,53,allow,198,102,96,2,29,1,1
49417,38558,0,0,deny,66,66,0,1,0,1,0
36841,443,36841,443,allow,4401,1494,2907,19,27,11,8
0,0,0,0,deny,156,156,0,2,0,2,0
3478,61463,0,0,deny,164,164,0,1,0,1,0
46442,80,6730,80,allow,1373,669,704,10,16,5,5
52802,80,4743,80,allow,1465,729,736,12,16,7,5
58245,445,0,0,drop,70,70,0,1,0,1,0
55773,445,0,0,drop,70,70,0,1,0,1,0
50651,25174,0,0,deny,62,62,0,1,0,1,0
55372,53,64639,53,allow,271,93,178,4,43,2,2
58638,5900,0,0,deny,62,62,0,1,0,1,0
53064,443,10926,443,allow,8095,2586,5509,38,90,19,19
27005,27015,1344,27015,allow,880,126,754,3,31,2,1
17010,57470,0,0,deny,62,62,0,1,0,1,0
56911,53,36658,53,allow,177,94,83,2,31,1,1
8358,80,8358,80,allow,1875,567,1308,11,31,6,5
51963,445,0,0,drop,70,70,0,1,0,1,0
34932,38608,0,0,deny,62,62,0,1,0,1,0
58483,443,25541,443,allow,3024,709,2315,13,120,6,7
53268,443,33392,443,allow,13176,4779,8397,47,17,29,18
49965,445,0,0,drop,70,70,0,1,0,1,0
50629,53,6662,53,allow,756,94,662,2,30,1,1
56975,53,38883,53,allow,197,102,95,2,29,1,1
25901,50265,0,0,deny,62,62,0,1,0,1,0
50599,80,5247,80,allow,8601,6265,2336,18,26,10,8
29195,51505,0,0,deny,146,146,0,1,0,1,0
53877,443,42282,443,allow,499,425,74,4,1,3,1
49528,443,34727,443,allow,5968,985,4983,17,28,8,9
13943,22,0,0,deny,60,60,0,1,0,1,0
51880,4000,30933,4000,allow,270,270,0,4,32,4,0
61768,445,0,0,drop,66,66,0,1,0,1,0
1227,56205,0,0,deny,66,66,0,1,0,1,0
49581,80,58944,80,allow,2339,1107,1232,11,21,6,5
64051,53,27383,53,allow,430,172,258,6,59,3,3
63583,37965,0,0,deny,62,62,0,1,0,1,0
23478,1433,0,0,deny,60,60,0,1,0,1,0
40561,443,22594,443,allow,3167,2456,711,15,16,10,5
57878,55108,0,0,deny,148,148,0,1,0,1,0
37835,443,55999,443,allow,63724,45783,17941,171,123,85,86
51682,443,60633,443,allow,5060,2867,2193,26,398,9,17
64677,53,61310,53,allow,183,94,89,2,31,1,1
61398,80,45091,80,allow,2425,529,1896,11,75,6,5
54550,443,8260,443,allow,3296,1329,1967,14,135,7,7
64560,53,36010,53,allow,184,94,90,2,29,1,1
41029,53,0,0,allow,86,86,0,1,29,1,0
52138,443,52138,443,allow,80933,20860,60073,121,324,66,55
65487,53,64939,53,allow,184,94,90,2,31,1,1
50624,26467,0,0,deny,66,66,0,1,0,1,0
50,64147,0,0,deny,66,66,0,1,0,1,0
60406,445,0,0,drop,66,66,0,1,0,1,0
57825,13014,0,0,deny,74,74,0,1,0,1,0
27005,27017,53801,27017,allow,1634,126,1508,4,31,2,2
64331,53,12876,53,allow,174,89,85,2,31,1,1
55226,443,25011,443,allow,711879,19394,692485,724,98,238,486
61230,53,16263,53,allow,177,94,83,2,29,1,1
58185,445,0,0,drop,66,66,0,1,0,1,0
60139,53,31222,53,allow,218,78,140,2,30,1,1
60893,443,5461,443,allow,46690,9390,37300,77,54,36,41
50372,443,12434,443,allow,456,390,66,4,0,3,1
64598,445,0,0,drop,70,70,0,1,0,1,0
46763,443,11187,443,allow,11876848,256539,11620309,11266,74,3584,7682
64579,445,0,0,drop,70,70,0,1,0,1,0
55533,53,2426,53,allow,183,94,89,2,30,1,1
60241,445,0,0,drop,70,70,0,1,0,1,0
55347,443,1685,443,allow,116686,21822,94864,224,186,112,112
57131,26296,0,0,deny,145,145,0,1,0,1,0
55353,53,50896,53,allow,311,86,225,4,55,2,2
50162,445,0,0,drop,70,70,0,1,0,1,0
55396,26467,0,0,deny,62,62,0,1,0,1,0
40204,40028,12239,40028,allow,143,81,62,2,30,1,1
51157,443,53397,443,allow,2791,1800,991,26,186,15,11
49677,25174,0,0,deny,62,62,0,1,0,1,0
56662,80,65360,80,allow,234,234,0,4,12,4,0
47132,1433,0,0,deny,60,60,0,1,0,1,0
65064,30188,0,0,deny,66,66,0,1,0,1,0
55979,53,24460,53,allow,168,86,82,2,30,1,1
53802,59932,27956,59932,allow,320,140,180,6,6,3,3
3541,22114,0,0,deny,62,62,0,1,0,1,0
1500,10387,0,0,deny,157,157,0,1,0,1,0
54896,445,0,0,drop,70,70,0,1,0,1,0
59807,53,15491,53,allow,263,94,169,2,30,1,1
58908,443,56510,443,allow,6278402,111931,6166471,5306,1119,732,4574
53656,31573,0,0,deny,66,66,0,1,0,1,0
39854,443,9295,443,allow,7903,3497,4406,38,72,22,16
64941,53,34820,53,allow,295,101,194,4,31,2,2
52051,29868,56419,29868,allow,70,70,0,2,8,2,0
62597,445,0,0,drop,70,70,0,1,0,1,0
39704,53,39704,53,allow,398,255,143,3,33,2,1
55224,53,2332,53,allow,182,94,88,2,30,1,1
52837,35440,0,0,deny,66,66,0,1,0,1,0
58884,23,0,0,deny,60,60,0,1,0,1,0
63437,445,0,0,drop,66,66,0,1,0,1,0
41581,443,9229,443,allow,6816,1197,5619,24,269,12,12
54129,445,0,0,drop,70,70,0,1,0,1,0
54471,445,0,0,drop,66,66,0,1,0,1,0
53589,445,0,0,drop,70,70,0,1,0,1,0
58049,50265,0,0,deny,145,145,0,1,0,1,0
45941,23386,0,0,deny,60,60,0,1,0,1,0
53686,8999,26730,8999,allow,70,70,0,1,4,1,0
57607,21247,0,0,deny,66,66,0,1,0,1,0
57523,25174,0,0,deny,146,146,0,1,0,1,0
54115,443,7544,443,allow,6840,1394,5446,29,270,14,15
51814,80,8693,80,allow,11975,2907,9068,24,38,14,10
56332,53,17265,53,allow,193,102,91,2,30,1,1
54093,5228,31167,5228,allow,7608,1824,5784,34,171,19,15
64751,443,49226,443,allow,507753,8795,498958,463,195,122,341
5588,5588,0,0,allow,3354,1792,1562,46,194,23,23
50263,53,23939,53,allow,172,94,78,2,30,1,1
49644,80,17566,80,allow,2950,601,2349,12,15,6,6
37574,123,51434,123,allow,184,94,90,2,30,1,1
56752,53,39858,53,allow,701,88,613,2,30,1,1
55333,123,5768,123,allow,184,94,90,2,30,1,1
27005,33060,38657,33060,allow,928,126,802,2,31,1,1
61404,52700,0,0,deny,72,72,0,1,0,1,0
62050,445,0,0,drop,66,66,0,1,0,1,0
49443,445,0,0,drop,70,70,0,1,0,1,0
58638,5900,0,0,deny,62,62,0,1,0,1,0
62003,445,0,0,drop,70,70,0,1,0,1,0
54298,48983,0,0,deny,159,159,0,1,0,1,0
14487,38303,0,0,deny,146,146,0,1,0,1,0
64649,53,32892,53,allow,807,94,713,2,30,1,1
56712,443,43897,443,allow,1540037,36876,1503161,1511,62,511,1000
61465,445,0,0,drop,66,66,0,1,0,1,0
58638,5900,0,0,deny,62,62,0,1,0,1,0
49482,80,62281,80,allow,378,192,186,7,39,4,3
50996,445,0,0,drop,66,66,0,1,0,1,0
58966,30188,0,0,deny,66,66,0,1,0,1,0
50605,443,56643,443,allow,1766,975,791,15,71,9,6
57211,445,0,0,drop,70,70,0,1,0,1,0
1848,53,1848,53,allow,832,106,726,2,29,1,1
65067,53,22984,53,allow,327,102,225,2,30,1,1
55218,53,56966,53,allow,402,142,260,2,30,1,1
43539,53,26606,53,allow,168,78,90,2,30,1,1
58638,5900,0,0,deny,62,62,0,1,0,1,0
64381,53,50743,53,allow,198,102,96,2,31,1,1
35098,443,17186,443,allow,7703,1606,6097,23,80,13,10
50494,445,0,0,drop,66,66,0,1,0,1,0
50355,43890,0,0,deny,66,66,0,1,0,1,0
39948,5223,55367,5223,allow,5551,1338,4213,28,1323,11,17
54471,36237,0,0,deny,66,66,0,1,0,1,0
60655,445,0,0,drop,70,70,0,1,0,1,0
57412,445,0,0,drop,70,70,0,1,0,1,0
65451,53,6208,53,allow,188,96,92,2,31,1,1
57665,52700,0,0,deny,66,66,0,1,0,1,0
6882,30499,61301,30499,allow,150,150,0,1,1200,1,0
22683,39210,0,0,deny,60,60,0,1,0,1,0
47531,8080,0,0,allow,184,78,106,3,10,2,1
49456,53,3975,53,allow,199,102,97,2,30,1,1
54351,53,59901,53,allow,168,78,90,2,29,1,1
64233,445,0,0,drop,66,66,0,1,0,1,0
55003,445,0,0,drop,70,70,0,1,0,1,0
56318,53,21992,53,allow,183,94,89,2,29,1,1
51500,443,60787,443,allow,451,259,192,5,23,2,3
60848,53,46740,53,allow,168,78,90,2,30,1,1
56512,443,45161,443,allow,155750,151462,4288,169,215,112,57
28011,443,11393,443,allow,5577,1390,4187,19,15,9,10
58638,5900,0,0,deny,62,62,0,1,0,1,0
60411,58131,27448,58131,allow,70,70,0,1,5,1,0
55705,53,9254,53,allow,281,101,180,4,58,2,2
49889,445,0,0,drop,66,66,0,1,0,1,0
43679,44847,0,0,deny,62,62,0,1,0,1,0
60498,443,60498,443,allow,8233,948,7285,18,30,10,8
49479,80,63239,80,allow,9192,4788,4404,30,126,17,13
52194,443,38386,443,allow,12374,1090,11284,27,15,13,14
60967,443,57765,443,allow,11529,8753,2776,41,120,22,19
11880,36829,0,0,deny,146,146,0,1,0,1,0
55734,445,0,0,drop,70,70,0,1,0,1,0
49418,27015,33472,27015,allow,71,71,0,1,30,1,0
55383,443,17690,443,allow,40612,4090,36522,71,150,31,40
57293,443,21825,443,allow,5161,2421,2740,14,122,7,7
53626,33194,41822,33194,allow,70,70,0,2,7,2,0
9467,443,18809,443,allow,5960,438,5522,16,15,6,10
62121,443,9258,443,allow,1864,250,1614,8,120,4,4
0,0,0,0,deny,98,98,0,1,0,1,0
60767,443,60767,443,allow,2406,1218,1188,21,16,11,10
49618,80,5688,80,allow,314,192,122,6,42,4,2
59763,443,10249,443,allow,24828,8387,16441,80,111,44,36
64973,445,0,0,drop,70,70,0,1,0,1,0
35864,44847,0,0,deny,78,78,0,1,0,1,0
59597,37965,0,0,deny,66,66,0,1,0,1,0
58638,5900,0,0,deny,62,62,0,1,0,1,0
50714,80,62410,80,allow,708,384,324,12,195,7,5
62731,21247,0,0,deny,66,66,0,1,0,1,0
58638,5900,0,0,deny,62,62,0,1,0,1,0
59890,443,21509,443,allow,9801,2337,7464,25,47,13,12
29509,25174,0,0,deny,62,62,0,1,0,1,0
55072,53,28531,53,allow,177,94,83,2,30,1,1
51979,80,40174,80,allow,366,240,126,7,25,5,2
58367,445,0,0,drop,70,70,0,1,0,1,0
58968,445,0,0,drop,66,66,0,1,0,1,0
6889,7363,0,0,deny,143,143,0,1,0,1,0
50412,80,26565,80,allow,1524,341,1183,11,36,4,7
62054,443,20146,443,allow,10596,3874,6722,30,62,17,13
55718,16805,50581,16805,allow,70,70,0,1,5,1,0
48009,443,46874,443,allow,4015,1813,2202,17,256,9,8
52275,445,0,0,drop,66,66,0,1,0,1,0
34429,443,39079,443,allow,1701,1048,653,15,38,8,7
21759,51505,0,0,deny,62,62,0,1,0,1,0
52004,443,64314,443,allow,4804,866,3938,19,26,10,9
27005,27015,42167,27015,allow,869,126,743,2,30,1,1
53481,445,0,0,drop,66,66,0,1,0,1,0
58223,445,0,0,drop,70,70,0,1,0,1,0
65513,53,15039,53,allow,195,102,93,2,31,1,1
21294,57470,0,0,deny,62,62,0,1,0,1,0
62441,443,36404,443,allow,4651,3116,1535,19,44,10,9
2525,23,0,0,deny,60,60,0,1,0,1,0
56844,443,48471,443,allow,10878,4815,6063,60,196,31,29
61108,445,0,0,drop,66,66,0,1,0,1,0
21496,50265,0,0,deny,62,62,0,1,0,1,0
49295,443,9529,443,allow,4179,2599,1580,27,75,13,14
57493,445,0,0,drop,70,70,0,1,0,1,0
55610,53,5256,53,allow,822,102,720,2,29,1,1
18650,23718,0,0,deny,62,62,0,1,0,1,0
41813,443,58792,443,allow,33072,3479,29593,71,98,38,33
34470,57470,0,0,deny,66,66,0,1,0,1,0
49888,53,39344,53,allow,198,102,96,2,30,1,1
30960,45746,57659,45746,allow,330,330,0,6,3609,6,0
64053,53,64602,53,allow,276,94,182,4,55,2,2
53044,445,0,0,drop,70,70,0,1,0,1,0
65514,53,32610,53,allow,214,110,104,2,31,1,1
64484,53,23929,53,allow,86,86,0,1,30,1,0
60432,445,0,0,drop,66,66,0,1,0,1,0
56086,53,3323,53,allow,172,94,78,2,29,1,1
63667,57470,0,0,deny,145,145,0,1,0,1,0
49968,53,43611,53,allow,751,94,657,2,30,1,1
49973,53,28904,53,allow,747,93,654,2,30,1,1
60606,445,0,0,drop,70,70,0,1,0,1,0
63217,445,0,0,drop,70,70,0,1,0,1,0
30114,65151,0,0,deny,60,60,0,1,0,1,0
52211,56648,11346,56648,allow,70,70,0,1,4,1,0
53792,445,0,0,drop,70,70,0,1,0,1,0
40512,57470,0,0,deny,74,74,0,1,0,1,0
57013,445,0,0,drop,70,70,0,1,0,1,0
51101,445,0,0,drop,66,66,0,1,0,1,0
62208,443,62208,443,allow,4497,1590,2907,19,29,11,8
52150,37603,39264,37603,allow,70,70,0,2,7,2,0
26287,56205,0,0,deny,62,62,0,1,0,1,0
55593,53,42641,53,allow,193,102,91,2,29,1,1
52088,445,0,0,drop,70,70,0,1,0,1,0
55119,53,12117,53,allow,994,86,908,2,29,1,1
57268,53,42841,53,allow,205,94,111,2,30,1,1
56948,53,35699,53,allow,93,93,0,1,30,1,0
50797,445,0,0,drop,66,66,0,1,0,1,0
51771,19103,1964,19103,allow,70,70,0,1,5,1,0
18592,44612,0,0,deny,62,62,0,1,0,1,0
55340,445,0,0,drop,70,70,0,1,0,1,0
52667,80,1897,80,allow,1272,633,639,9,150,5,4
50345,443,44342,443,allow,1385,868,517,12,30,6,6
53701,8999,10439,8999,allow,1328,960,368,10,32,5,5
55774,8060,21425,8060,allow,70,70,0,1,5,1,0
56906,445,0,0,drop,70,70,0,1,0,1,0
63616,443,48346,443,allow,1296,612,684,18,120,9,9
54942,53,0,0,allow,631,74,557,2,30,1,1
55545,445,0,0,drop,66,66,0,1,0,1,0
61701,44847,0,0,deny,66,66,0,1,0,1,0
49966,445,0,0,drop,70,70,0,1,0,1,0
49848,53,31476,53,allow,167,86,81,2,30,1,1
60681,445,0,0,drop,70,70,0,1,0,1,0
59987,445,0,0,drop,70,70,0,1,0,1,0
56798,9571,0,0,deny,66,66,0,1,0,1,0
62908,993,3979,993,allow,8772,3614,5158,77,54,35,42
53635,22383,54338,22383,allow,492,306,186,8,17,5,3
60476,80,59400,80,allow,613,539,74,7,15,6,1
26528,51221,0,0,deny,78,78,0,1,0,1,0
49905,53,25136,53,allow,180,94,86,2,30,1,1
55100,53,15692,53,allow,182,102,80,2,30,1,1
49891,53,6545,53,allow,375,126,249,2,30,1,1
64726,53,22205,53,allow,231,94,137,2,30,1,1
65045,53,53307,53,allow,194,99,95,2,30,1,1
4438,23,0,0,deny,60,60,0,1,0,1,0
49365,445,0,0,drop,70,70,0,1,0,1,0
53415,445,0,0,drop,66,66,0,1,0,1,0
51616,443,56570,443,allow,62241,4598,57643,82,170,35,47
35178,8635,35178,8635,allow,138,78,60,2,5,1,1
50875,443,41381,443,allow,1786,172,1614,7,121,3,4
49218,443,48762,443,allow,8929,3316,5613,38,255,18,20
49825,53,30889,53,allow,336,110,226,2,31,1,1
32090,43890,0,0,deny,146,146,0,1,0,1,0
59576,445,0,0,drop,70,70,0,1,0,1,0
49606,80,25049,80,allow,454,262,192,8,41,5,3
55693,443,55693,443,allow,23467,2707,20760,45,80,21,24
50391,445,0,0,drop,70,70,0,1,0,1,0
58916,443,3751,443,allow,6376,4098,2278,20,16,10,10
3717,25174,0,0,deny,62,62,0,1,0,1,0
51898,50677,11184,50677,allow,70,70,0,2,8,2,0
64737,53,51522,53,allow,757,98,659,2,0,1,1
62217,37807,0,0,deny,66,66,0,1,0,1,0
32071,51221,0,0,deny,66,66,0,1,0,1,0
62389,445,0,0,drop,70,70,0,1,0,1,0
51401,443,22599,443,allow,202,70,132,3,11,1,2
51140,80,51140,80,allow,514,246,268,9,42,5,4
64493,53,45305,53,allow,198,101,97,2,30,1,1
56689,53,17079,53,allow,264,91,173,4,38,2,2
49494,445,0,0,drop,70,70,0,1,0,1,0
35915,443,57098,443,allow,1786,172,1614,7,120,3,4
52282,445,0,0,drop,66,66,0,1,0,1,0
56679,5900,0,0,deny,60,60,0,1,0,1,0
61740,443,10410,443,allow,9854,2716,7138,36,49,20,16
19885,64147,0,0,deny,62,62,0,1,0,1,0
51373,445,0,0,drop,66,66,0,1,0,1,0
52148,80,27900,80,allow,366,240,126,7,33,5,2
52035,36498,46508,36498,allow,70,70,0,2,9,2,0
38168,443,45970,443,allow,6136,1404,4732,20,979,10,10
35796,443,15213,443,allow,664348,23858,640490,757,119,292,465
49940,80,46739,80,allow,1130,613,517,11,15,6,5
64606,53,12951,53,allow,290,102,188,2,30,1,1
49820,53,34423,53,allow,193,102,91,2,30,1,1
49203,53,46082,53,allow,168,86,82,2,31,1,1
63823,445,0,0,drop,66,66,0,1,0,1,0
56293,53,53120,53,allow,164,84,80,2,31,1,1
54276,37628,0,0,deny,66,66,0,1,0,1,0
50446,80,5062,80,allow,318,192,126,6,27,4,2
55828,443,33777,443,allow,8420,4472,3948,63,450,32,31
55072,53,31850,53,allow,168,86,82,2,31,1,1
49191,35440,0,0,deny,66,66,0,1,0,1,0
57215,53,55858,53,allow,810,108,702,2,30,1,1
59413,51505,0,0,deny,66,66,0,1,0,1,0
29300,35440,0,0,deny,62,62,0,1,0,1,0
61736,443,61172,443,allow,148467,8298,140169,192,17,93,99
62454,443,55667,443,allow,18884,4117,14767,37,25,16,21
63802,445,0,0,drop,66,66,0,1,0,1,0
49801,443,19605,443,allow,44380,1589,42791,48,126,14,34
50738,445,0,0,drop,70,70,0,1,0,1,0
50238,445,0,0,drop,70,70,0,1,0,1,0
52812,25174,0,0,deny,66,66,0,1,0,1,0
58638,5900,0,0,deny,62,62,0,1,0,1,0
10532,26672,0,0,deny,60,60,0,1,0,1,0
62392,15503,0,0,deny,62,62,0,1,0,1,0
51325,445,0,0,drop,70,70,0,1,0,1,0
56641,443,17125,443,allow,7942,1953,5989,20,15,11,9
57587,443,4519,443,allow,15613,1408,14205,32,125,15,17
56231,53,22476,53,allow,779,86,693,2,30,1,1
65469,443,41637,443,allow,92958,4869,88089,109,15,44,65
64146,445,0,0,drop,66,66,0,1,0,1,0
63840,36829,0,0,deny,62,62,0,1,0,1,0
56365,53,1142,53,allow,198,101,97,2,30,1,1
53198,53,24028,53,allow,365,86,279,2,30,1,1
64657,53,42843,53,allow,816,102,714,2,30,1,1
56662,443,10328,443,allow,318,192,126,6,15,4,2
47508,443,1346,443,allow,5778,1095,4683,17,26,10,7
53012,51050,0,0,deny,66,66,0,1,0,1,0
59051,27520,0,0,deny,62,62,0,1,0,1,0
28839,30188,0,0,deny,62,62,0,1,0,1,0
56077,445,0,0,drop,70,70,0,1,0,1,0
60862,443,5299,443,allow,12604,6376,6228,27,133,16,11
60297,25604,0,0,deny,62,62,0,1,0,1,0
64467,53,41082,53,allow,548,194,354,6,63,3,3
57604,32480,0,0,deny,62,62,0,1,0,1,0
55229,53,60362,53,allow,720,94,626,2,30,1,1
44924,53,44924,53,allow,235,90,145,2,32,1,1
61199,445,0,0,drop,70,70,0,1,0,1,0
49540,53,53210,53,allow,198,110,88,2,30,1,1
56529,53,60444,53,allow,711,87,624,2,31,1,1
55835,53,25257,53,allow,180,94,86,2,30,1,1
49214,443,4327,443,allow,17273,11238,6035,73,919,36,37
49152,514,0,0,allow,142,142,0,2,30,2,0
64765,445,0,0,drop,66,66,0,1,0,1,0
56328,36237,0,0,deny,66,66,0,1,0,1,0
55221,443,65521,443,allow,10435,2860,7575,27,46,15,12
63461,51505,0,0,deny,66,66,0,1,0,1,0
57274,443,44033,443,allow,11536,2572,8964,41,33,24,17
65483,53,14095,53,allow,701,88,613,2,31,1,1
58370,443,50234,443,allow,6277528,124223,6153305,5970,160,1890,4080
53459,37807,0,0,deny,146,146,0,1,0,1,0
56519,53,63557,53,allow,166,85,81,2,31,1,1
56148,37965,0,0,deny,66,66,0,1,0,1,0
39042,443,16986,443,allow,19733,3606,16127,43,16,22,21
7099,51505,0,0,deny,62,62,0,1,0,1,0
61700,53,61700,53,allow,221,90,131,2,30,1,1
50200,53,14002,53,allow,758,102,656,2,30,1,1
64912,53,47656,53,allow,183,94,89,2,30,1,1
54979,53,4787,53,allow,102,102,0,1,59,1,0
58248,53,0,0,allow,186,83,103,2,30,1,1
57288,53,40155,53,allow,170,87,83,2,30,1,1
49907,445,0,0,drop,70,70,0,1,0,1,0
54649,445,0,0,drop,70,70,0,1,0,1,0
56085,53,34233,53,allow,167,86,81,2,30,1,1
63301,445,0,0,drop,70,70,0,1,0,1,0
52059,445,0,0,drop,70,70,0,1,0,1,0
50584,48493,7175,48493,allow,161,161,0,1,1200,1,0
53169,44707,23330,44707,allow,1078,518,560,16,21,9,7
52329,443,64562,443,allow,294025,14919,279106,401,42,192,209
58055,80,48571,80,allow,3791,2804,987,14,31,8,6
50787,445,0,0,drop,66,66,0,1,0,1,0
56878,443,56878,443,allow,27657,5506,22151,58,46,30,28
57181,53,65198,53,allow,733,93,640,2,31,1,1
59572,445,0,0,drop,70,70,0,1,0,1,0
60225,443,43705,443,allow,8989,3335,5654,65,152,31,34
52776,80,21861,80,allow,432,240,192,8,101,5,3
65177,445,0,0,drop,66,66,0,1,0,1,0
47595,33438,0,0,allow,106,106,0,1,60,1,0
53876,53380,35736,53380,allow,70,70,0,2,8,2,0
63763,17368,8449,17368,allow,66,66,0,1,5,1,0
60241,443,3002,443,allow,92975,3289,89686,107,316,40,67
56755,53,8890,53,allow,663,212,451,6,63,3,3
49418,27014,18652,27014,allow,249,78,171,2,31,1,1
56562,53,4746,53,allow,183,94,89,2,29,1,1
55641,443,52887,443,allow,6133,1655,4478,12,119,5,7
40785,443,32724,443,allow,646,292,354,10,41,5,5
61484,445,0,0,drop,70,70,0,1,0,1,0
50412,445,0,0,drop,66,66,0,1,0,1,0
50755,80,50755,80,allow,450,246,204,8,25,5,3
59772,443,48331,443,allow,181413,11493,169920,167,85,41,126
58794,5222,61380,5222,allow,47445,16812,30633,144,870,65,79
63553,445,0,0,drop,66,66,0,1,0,1,0
54963,445,0,0,drop,70,70,0,1,0,1,0
44883,53,44883,53,allow,216,90,126,2,29,1,1
59693,443,23790,443,allow,1867,250,1617,8,120,4,4
55484,53,28906,53,allow,711,87,624,2,30,1,1
59982,443,64265,443,allow,7693,1284,6409,24,81,12,12
49206,53,44411,53,allow,179,94,85,2,30,1,1
50613,53,60735,53,allow,814,110,704,2,30,1,1
58142,445,0,0,drop,70,70,0,1,0,1,0
61660,64097,0,0,deny,62,62,0,1,0,1,0
11066,50584,0,0,deny,62,62,0,1,0,1,0
27005,32065,28721,32065,allow,877,126,751,2,31,1,1
36810,80,28528,80,allow,18460,3166,15294,34,32,18,16
65418,53,5528,53,allow,197,94,103,2,30,1,1
58011,445,0,0,drop,70,70,0,1,0,1,0
51842,27665,50059,27665,allow,70,70,0,1,5,1,0
56582,53,45398,53,allow,196,102,94,2,33,1,1
443,10010,0,0,deny,60,60,0,1,0,1,0
49358,443,2362,443,allow,9482,4710,4772,19,16,11,8
51904,51883,50262,51883,allow,70,70,0,1,5,1,0
55342,443,55342,443,allow,5593,2346,3247,22,39,13,9
45232,80,45232,80,allow,2895,1484,1411,10,15,6,4
57359,53,20340,53,allow,458,188,270,6,31,3,3
49488,53,29306,53,allow,194,102,92,2,30,1,1
1027,65473,0,0,deny,159,159,0,1,0,1,0
19875,30170,0,0,deny,145,145,0,1,0,1,0
49439,53,62852,53,allow,194,99,95,2,31,1,1
58113,445,0,0,drop,70,70,0,1,0,1,0
27005,33058,7981,33058,allow,884,126,758,2,31,1,1
65498,53,39980,53,allow,209,110,99,2,30,1,1
58638,5900,58638,5900,allow,160,66,94,2,9,1,1
55820,53,24388,53,allow,188,96,92,2,31,1,1
61392,445,0,0,drop,70,70,0,1,0,1,0
61831,445,0,0,drop,66,66,0,1,0,1,0
55056,56205,0,0,deny,66,66,0,1,0,1,0
56709,443,54114,443,allow,8007,1987,6020,20,15,11,9
50315,445,0,0,drop,66,66,0,1,0,1,0
57207,53,55086,53,allow,195,102,93,2,30,1,1
56772,53,9066,53,allow,168,86,82,2,30,1,1
34134,30188,0,0,deny,62,62,0,1,0,1,0
45941,23386,0,0,deny,60,60,0,1,0,1,0
40500,48009,0,0,deny,146,146,0,1,0,1,0
56711,53,61949,53,allow,209,110,99,2,31,1,1
49714,53,19961,53,allow,490,101,389,4,45,2,2
53231,443,2130,443,allow,8906,1533,7373,32,58,16,16
51412,443,35247,443,allow,200230,8733,191497,250,122,106,144
61430,80,6930,80,allow,214,140,74,4,41,3,1
60064,445,0,0,drop,70,70,0,1,0,1,0
27328,21247,0,0,deny,62,62,0,1,0,1,0
51692,445,0,0,drop,70,70,0,1,0,1,0
55028,443,3475,443,allow,1403116,30089,1373027,1321,32,404,917
57425,443,33540,443,allow,130,70,60,2,15,1,1
49476,53,24497,53,allow,402,118,284,2,29,1,1
54898,443,54771,443,allow,78537,4022,74515,120,386,55,65
56600,80,32176,80,allow,234,234,0,4,12,4,0
49319,53,1935,53,allow,166,86,80,2,29,1,1
60720,23718,0,0,deny,62,62,0,1,0,1,0
54976,15503,0,0,deny,66,66,0,1,0,1,0
55261,53,37106,53,allow,177,94,83,2,30,1,1
49918,53,24031,53,allow,196,100,96,2,31,1,1
51950,17499,60701,17499,allow,66,66,0,1,5,1,0
53947,867,6908,867,allow,70,70,0,1,5,1,0
54501,80,17667,80,allow,254,128,126,5,16,3,2
53911,443,57422,443,allow,1346,918,428,10,33,6,4
58638,5900,58638,5900,allow,156,62,94,2,10,1,1
56687,53,1087,53,allow,225,110,115,2,30,1,1
56847,53,25632,53,allow,225,86,139,2,30,1,1
9836,22114,0,0,deny,62,62,0,1,0,1,0
8907,443,50464,443,allow,7594,1457,6137,26,404,10,16
58593,57470,0,0,deny,62,62,0,1,0,1,0
56221,443,24462,443,allow,129824,16359,113465,185,459,79,106
64956,53,40414,53,allow,402,118,284,2,29,1,1
9742,80,9742,80,allow,1384,648,736,9,15,5,4
49334,53,34104,53,allow,194,102,92,2,30,1,1
55155,445,0,0,drop,70,70,0,1,0,1,0
54104,445,0,0,drop,70,70,0,1,0,1,0
58934,53,32905,53,allow,205,86,119,2,30,1,1
60061,443,58385,443,allow,3195,1426,1769,15,141,8,7
49477,53,44035,53,allow,168,78,90,2,30,1,1
51919,80,35345,80,allow,16004,8270,7734,32,57,17,15
64041,445,0,0,drop,70,70,0,1,0,1,0
60761,40010,63900,40010,allow,316,136,180,6,6,3,3
60495,6882,21325,6882,allow,70,70,0,1,5,1,0
55680,23711,32600,23711,allow,70,70,0,1,5,1,0
65403,53,11897,53,allow,199,102,97,2,31,1,1
56912,53,5094,53,allow,199,102,97,2,29,1,1
39548,8696,0,0,deny,60,60,0,1,0,1,0
49224,80,15279,80,allow,2999,2271,728,11,15,6,5
47281,443,8413,443,allow,190,70,120,4,15,2,2
53218,56205,0,0,deny,66,66,0,1,0,1,0
50427,80,43709,80,allow,312,192,120,6,27,4,2
58457,445,0,0,drop,70,70,0,1,0,1,0
27005,27015,49049,27015,allow,1610,126,1484,4,30,2,2
53859,443,52772,443,allow,499,425,74,4,1,3,1
31683,35440,0,0,deny,146,146,0,1,0,1,0
50622,80,45334,80,allow,11907,10409,1498,28,52,16,12
56581,25174,0,0,deny,146,146,0,1,0,1,0
56914,53,35890,53,allow,100,100,0,2,35,2,0
49480,53,58009,53,allow,184,94,90,2,31,1,1
56876,53,55574,53,allow,711,87,624,2,31,1,1
53270,443,30676,443,allow,6894,1556,5338,23,3601,13,10
27677,22114,0,0,deny,146,146,0,1,0,1,0
49765,443,5454,443,allow,11588,4383,7205,39,46,22,17
61271,445,0,0,drop,66,66,0,1,0,1,0
20641,53,20641,53,allow,240,98,142,2,29,1,1
47910,7461,0,0,deny,60,60,0,1,0,1,0
63032,445,0,0,drop,70,70,0,1,0,1,0
52601,443,40695,443,allow,2046,1026,1020,17,80,9,8
51304,443,39350,443,allow,5839,3609,2230,25,361,13,12
56098,64147,0,0,deny,66,66,0,1,0,1,0
51533,44847,0,0,deny,62,62,0,1,0,1,0
64792,445,0,0,drop,66,66,0,1,0,1,0
64551,53,37333,53,allow,495,127,368,4,33,2,2
59587,445,0,0,drop,66,66,0,1,0,1,0
64947,53,11296,53,allow,275,96,179,4,41,2,2
6824,26467,0,0,deny,62,62,0,1,0,1,0
50265,443,33031,443,allow,23684,13193,10491,84,63,44,40
49608,445,0,0,deny,70,70,0,1,0,1,0
60498,445,0,0,drop,70,70,0,1,0,1,0
58835,445,0,0,drop,70,70,0,1,0,1,0
65060,53,36666,53,allow,761,100,661,2,30,1,1
53618,1025,19237,1025,allow,320,140,180,6,7,3,3
60100,445,0,0,drop,66,66,0,1,0,1,0
55134,53,55134,53,allow,825,99,726,2,31,1,1
55544,3389,55544,3389,allow,3657,1638,2019,20,18,11,9
53815,445,0,0,drop,70,70,0,1,0,1,0
52168,62118,28732,62118,allow,70,70,0,1,5,1,0
9151,443,63028,443,allow,6128,763,5365,17,29,9,8
64102,445,0,0,drop,70,70,0,1,0,1,0
49248,53,8891,53,allow,211,102,109,2,30,1,1
64171,53,30410,53,allow,94,94,0,1,30,1,0
59977,445,0,0,drop,70,70,0,1,0,1,0
3478,61463,0,0,deny,1103,1103,0,1,0,1,0
26921,57470,0,0,deny,62,62,0,1,0,1,0
48297,443,9986,443,allow,7320,1817,5503,41,106,16,25
57061,53,39332,53,allow,1780,674,1106,18,68,9,9
50422,50584,0,0,deny,66,66,0,1,0,1,0
49897,443,63900,443,allow,113036,13164,99872,191,144,89,102
56962,53,9303,53,allow,177,94,83,2,30,1,1
60199,443,60774,443,allow,8958,1697,7261,18,15,9,9
39043,443,33177,443,allow,4832,3054,1778,27,16,14,13
65494,53,0,0,deny,88,88,0,1,0,1,0
51167,443,46694,443,allow,13777,1743,12034,26,31,12,14
54456,445,0,0,drop,66,66,0,1,0,1,0
44739,443,37697,443,allow,6220,1790,4430,19,120,10,9
55789,445,0,0,drop,66,66,0,1,0,1,0
34112,44847,0,0,deny,66,66,0,1,0,1,0
41852,35440,0,0,deny,62,62,0,1,0,1,0
58443,443,26143,443,allow,12060,3749,8311,42,17,23,19
57655,56205,0,0,deny,66,66,0,1,0,1,0
56966,35440,0,0,deny,62,62,0,1,0,1,0
54998,53,17431,53,allow,711,87,624,2,30,1,1
65112,53,6227,53,allow,209,110,99,2,31,1,1
50470,61463,0,0,deny,86,86,0,1,0,1,0
54993,443,50582,443,allow,38985,4250,34735,58,19,27,31
45238,44847,0,0,deny,62,62,0,1,0,1,0
48847,443,1416,443,allow,2523,1483,1040,19,276,10,9
50095,53,54067,53,allow,146,75,71,2,31,1,1
64462,53,49415,53,allow,179,94,85,2,30,1,1
51414,22,0,0,deny,60,60,0,1,0,1,0
44884,443,49689,443,allow,296,78,218,4,19,1,3
52234,64624,43132,64624,allow,136,136,0,3,14,3,0
56816,443,16188,443,allow,7956,1967,5989,20,15,11,9
55103,445,0,0,drop,70,70,0,1,0,1,0
65374,445,0,0,drop,66,66,0,1,0,1,0
57949,445,0,0,drop,66,66,0,1,0,1,0
50299,445,0,0,drop,70,70,0,1,0,1,0
41462,443,16265,443,allow,3467,2269,1198,21,82,11,10
56504,53,45710,53,allow,102,102,0,1,30,1,0
33525,53,23050,53,allow,168,78,90,2,31,1,1
52076,44847,0,0,deny,66,66,0,1,0,1,0
27005,27057,9296,27057,allow,917,126,791,2,31,1,1
50137,1433,0,0,deny,60,60,0,1,0,1,0
24236,8055,0,0,deny,148,148,0,1,0,1,0
49547,53,39009,53,allow,193,102,91,2,30,1,1
61790,445,0,0,drop,66,66,0,1,0,1,0
56715,445,0,0,drop,70,70,0,1,0,1,0
64321,53,31319,53,allow,190,97,93,2,31,1,1
56041,53,5205,53,allow,183,94,89,2,30,1,1
61349,445,0,0,drop,66,66,0,1,0,1,0
60932,445,0,0,drop,70,70,0,1,0,1,0
26900,27017,48615,27017,allow,422,164,258,6,30,3,3
52459,5555,0,0,deny,60,60,0,1,0,1,0
1182,23,0,0,deny,60,60,0,1,0,1,0
27005,27016,25389,27016,allow,1006,252,754,4,32,3,1
56669,80,21282,80,allow,234,234,0,4,12,4,0
10192,25174,0,0,deny,66,66,0,1,0,1,0
52111,44847,0,0,deny,62,62,0,1,0,1,0
53879,445,0,0,drop,70,70,0,1,0,1,0
56631,445,0,0,drop,66,66,0,1,0,1,0
62552,445,0,0,drop,70,70,0,1,0,1,0
29972,50584,0,0,deny,62,62,0,1,0,1,0
54936,80,14845,80,allow,613,539,74,7,15,6,1
50975,445,0,0,drop,66,66,0,1,0,1,0
36563,6851,45259,6851,allow,7584,4075,3509,51,169,27,24
51198,443,22207,443,allow,8075,2723,5352,42,117,24,18
59943,37807,0,0,deny,62,62,0,1,0,1,0
65260,53,8952,53,allow,199,102,97,2,30,1,1
57987,56125,0,0,deny,90,90,0,1,0,1,0
63690,64147,0,0,deny,62,62,0,1,0,1,0
52828,445,0,0,drop,70,70,0,1,0,1,0
59965,36237,0,0,deny,66,66,0,1,0,1,0
32974,37965,0,0,deny,66,66,0,1,0,1,0
54138,443,3905,443,allow,5702,1212,4490,19,139,10,9
50151,445,0,0,drop,66,66,0,1,0,1,0
45944,44847,0,0,deny,146,146,0,1,0,1,0
37570,443,52731,443,allow,130,64,66,3,6,2,1
50360,35440,0,0,deny,66,66,0,1,0,1,0
64249,445,0,0,drop,70,70,0,1,0,1,0
51795,443,38241,443,allow,4209,2221,1988,25,157,12,13
56809,53,8718,53,allow,232,94,138,2,30,1,1
44849,46478,0,0,deny,74,74,0,1,0,1,0
59951,53,55881,53,allow,237,86,151,2,30,1,1
54639,445,0,0,drop,70,70,0,1,0,1,0
49712,53,30095,53,allow,178,94,84,2,29,1,1
50146,445,0,0,drop,66,66,0,1,0,1,0
56081,53,46764,53,allow,186,102,84,2,29,1,1
63203,445,0,0,drop,70,70,0,1,0,1,0
46056,443,52673,443,allow,80200,69062,11138,193,89,100,93
26332,57470,0,0,deny,62,62,0,1,0,1,0
58549,445,0,0,drop,66,66,0,1,0,1,0
59728,5900,0,0,deny,60,60,0,1,0,1,0
52033,445,0,0,drop,70,70,0,1,0,1,0
24144,57470,0,0,deny,62,62,0,1,0,1,0
49717,57470,0,0,deny,62,62,0,1,0,1,0
61559,53,9585,53,allow,376,86,290,2,29,1,1
55193,53,2306,53,allow,177,94,83,2,30,1,1
55463,53,53091,53,allow,216,110,106,2,31,1,1
50584,49376,27285,49376,allow,1320,300,1020,6,1200,3,3
53166,39564,27898,39564,allow,70,70,0,2,8,2,0
50012,53,27557,53,allow,212,110,102,2,30,1,1
50968,445,0,0,drop,70,70,0,1,0,1,0
64872,445,0,0,drop,70,70,0,1,0,1,0
60892,445,0,0,drop,70,70,0,1,0,1,0
55070,445,0,0,drop,66,66,0,1,0,1,0
37008,42707,0,0,deny,62,62,0,1,0,1,0
59082,445,0,0,drop,66,66,0,1,0,1,0
52096,80,38227,80,allow,366,240,126,7,25,5,2
49543,53,11834,53,allow,779,110,669,2,30,1,1
34193,17,0,0,deny,60,60,0,1,0,1,0
55456,53,57964,53,allow,711,87,624,2,30,1,1
53087,443,59846,443,allow,408922,10621,398301,421,121,145,276
64999,53,33322,53,allow,178,94,84,2,29,1,1
53939,445,0,0,drop,66,66,0,1,0,1,0
59784,443,16677,443,allow,6698,1606,5092,23,19,13,10
64035,25174,0,0,deny,146,146,0,1,0,1,0
52216,445,0,0,drop,66,66,0,1,0,1,0
53298,26467,0,0,deny,62,62,0,1,0,1,0
47595,33434,0,0,allow,106,106,0,1,60,1,0
49659,80,54132,80,allow,1937,885,1052,13,42,7,6
57470,61467,29646,61467,allow,479,150,329,2,1199,1,1
54314,53,25378,53,allow,284,79,205,2,30,1,1
55012,64147,0,0,deny,66,66,0,1,0,1,0
64150,22114,0,0,deny,66,66,0,1,0,1,0
51425,37450,0,0,deny,62,62,0,1,0,1,0
58201,445,0,0,drop,66,66,0,1,0,1,0
56671,80,31736,80,allow,234,234,0,4,12,4,0
52340,64147,0,0,deny,66,66,0,1,0,1,0
60521,443,45323,443,allow,45001,3799,41202,74,331,35,39
61933,445,0,0,drop,70,70,0,1,0,1,0
49556,80,42311,80,allow,7002,5717,1285,15,45,9,6
65419,53,45268,53,allow,199,102,97,2,30,1,1
48574,443,45361,443,allow,9336,1153,8183,27,34,14,13
49248,35993,0,0,deny,66,66,0,1,0,1,0
59801,443,35070,443,allow,5678,2820,2858,25,141,11,14
49676,53,32954,53,allow,197,102,95,2,30,1,1
56638,64147,0,0,deny,62,62,0,1,0,1,0
56633,53,17988,53,allow,194,99,95,2,31,1,1
12841,37965,0,0,deny,62,62,0,1,0,1,0
34768,443,44621,443,allow,21905,3249,18656,38,271,18,20
58085,57470,0,0,deny,66,66,0,1,0,1,0
60053,443,33088,443,allow,3190,1599,1591,17,142,9,8
59549,50584,0,0,deny,66,66,0,1,0,1,0
60406,443,21053,443,allow,8404,1892,6512,23,30,12,11
2837,25174,0,0,deny,66,66,0,1,0,1,0
47788,30170,0,0,deny,146,146,0,1,0,1,0
11228,25174,0,0,deny,66,66,0,1,0,1,0
60957,445,0,0,drop,70,70,0,1,0,1,0
53437,44847,0,0,deny,66,66,0,1,0,1,0
52725,445,0,0,drop,66,66,0,1,0,1,0
55046,53,35740,53,allow,198,102,96,2,30,1,1
61769,445,0,0,drop,70,70,0,1,0,1,0
53765,16178,2985,16178,allow,70,70,0,1,5,1,0
57633,50584,0,0,deny,62,62,0,1,0,1,0
64576,445,0,0,drop,66,66,0,1,0,1,0
32967,80,37431,80,allow,21387,1482,19905,38,18,19,19
58101,445,0,0,drop,66,66,0,1,0,1,0
56920,445,0,0,drop,70,70,0,1,0,1,0
37965,61282,39357,61282,allow,402,132,270,6,1208,3,3
38707,443,59526,443,allow,774099,15769,758330,743,16,223,520
56163,53,14069,53,allow,265,85,180,4,42,2,2
9298,443,38844,443,allow,4216,771,3445,16,26,9,7
56775,53,64956,53,allow,177,94,83,2,29,1,1
64439,53,35218,53,allow,199,102,97,2,31,1,1
38629,25174,0,0,deny,62,62,0,1,0,1,0
50208,1688,43148,1688,allow,70,70,0,1,5,1,0
54930,445,0,0,drop,70,70,0,1,0,1,0
58638,5900,0,0,deny,62,62,0,1,0,1,0
53115,445,0,0,drop,70,70,0,1,0,1,0
20198,17372,0,0,deny,62,62,0,1,0,1,0
49179,53,18943,53,allow,309,118,191,2,30,1,1
5588,5588,0,0,allow,3562,1936,1626,48,195,24,24
61156,445,0,0,drop,70,70,0,1,0,1,0
64779,53,1103,53,allow,810,108,702,2,30,1,1
26940,53,26940,53,allow,197,90,107,2,30,1,1
55580,53,20402,53,allow,195,102,93,2,30,1,1
55618,56205,0,0,deny,66,66,0,1,0,1,0
64297,53,33648,53,allow,199,94,105,2,30,1,1
20508,57470,0,0,deny,62,62,0,1,0,1,0
62386,37965,0,0,deny,66,66,0,1,0,1,0
55220,53,13554,53,allow,193,102,91,2,30,1,1
52779,445,0,0,drop,70,70,0,1,0,1,0
22927,48817,0,0,deny,143,143,0,1,0,1,0
57287,53,44650,53,allow,752,93,659,2,30,1,1
57118,443,64702,443,allow,5133,631,4502,14,15,8,6
35619,12883,0,0,deny,159,159,0,1,0,1,0
51815,80,14356,80,allow,3910,2158,1752,15,32,10,5
50997,445,0,0,drop,70,70,0,1,0,1,0
50661,443,13443,443,allow,298067,6719,291348,307,17,98,209
55452,53,54913,53,allow,184,94,90,2,30,1,1
18415,37965,0,0,deny,62,62,0,1,0,1,0
64790,53,58871,53,allow,88,88,0,1,30,1,0
56114,53,59313,53,allow,216,110,106,2,30,1,1
53661,443,31154,443,allow,8267,1779,6488,23,150,13,10
23066,443,23066,443,allow,5573,2434,3139,21,25,12,9
61583,64147,0,0,deny,66,66,0,1,0,1,0
57408,53,58813,53,allow,190,97,93,2,30,1,1
58076,21247,0,0,deny,62,62,0,1,0,1,0
55489,445,0,0,drop,70,70,0,1,0,1,0
55173,445,0,0,drop,70,70,0,1,0,1,0
50944,445,0,0,drop,70,70,0,1,0,1,0
64272,53,63528,53,allow,626,190,436,6,60,3,3
56415,443,20835,443,allow,6032,1722,4310,22,117,13,9
53352,445,0,0,drop,66,66,0,1,0,1,0
46734,53,46734,53,allow,314,98,216,2,29,1,1
56929,53,5055,53,allow,170,87,83,2,30,1,1
50520,80,14281,80,allow,1615,793,822,13,91,7,6
50276,5223,4771,5223,allow,552,280,272,9,16,5,4
24127,56205,0,0,deny,66,66,0,1,0,1,0
51365,445,0,0,drop,66,66,0,1,0,1,0
49738,53,2728,53,allow,215,102,113,2,30,1,1
40826,443,36041,443,allow,4125,2847,1278,18,255,10,8
45630,443,4110,443,allow,2996,1629,1367,17,21,9,8
61755,445,0,0,drop,70,70,0,1,0,1,0
31172,22114,0,0,deny,62,62,0,1,0,1,0
49352,443,51520,443,allow,10055,1184,8871,21,76,9,12
60709,53,36089,53,allow,260,86,174,2,30,1,1
49440,53,64789,53,allow,415,88,327,4,52,2,2
47342,36237,0,0,deny,62,62,0,1,0,1,0
54796,22114,0,0,deny,66,66,0,1,0,1,0
54054,5228,24551,5228,allow,8767,2486,6281,45,6062,24,21
56724,53,0,0,allow,86,86,0,1,30,1,0
60916,445,0,0,drop,70,70,0,1,0,1,0
56648,53,44024,53,allow,199,102,97,2,30,1,1
64335,35440,0,0,deny,62,62,0,1,0,1,0
56092,53,54654,53,allow,177,94,83,2,30,1,1
15503,51413,47539,51413,allow,459,149,310,2,1200,1,1
30478,53,30478,53,allow,229,89,140,2,30,1,1
42040,5228,65521,5228,allow,3467,1977,1490,29,3742,14,15
59920,443,55787,443,allow,3063,1068,1995,12,134,6,6
56943,44847,0,0,deny,62,62,0,1,0,1,0
50098,53,35550,53,allow,199,102,97,2,31,1,1
55183,445,0,0,drop,70,70,0,1,0,1,0
52086,80,55343,80,allow,2703,632,2071,12,22,7,5
53660,443,62189,443,allow,2955,864,2091,11,119,5,6
55570,53,7060,53,allow,889,404,485,10,30,5,5
51927,80,21213,80,allow,1945,1002,943,11,20,7,4
34400,39004,0,0,deny,74,74,0,1,0,1,0
65069,445,0,0,drop,66,66,0,1,0,1,0
54766,445,0,0,drop,70,70,0,1,0,1,0
53874,445,0,0,drop,70,70,0,1,0,1,0
51649,80,42317,80,allow,1965,1402,563,13,16,7,6
55126,53,61612,53,allow,193,102,91,2,29,1,1
50707,445,0,0,drop,70,70,0,1,0,1,0
49621,53,6731,53,allow,501,188,313,6,33,3,3
56770,443,61506,443,allow,5829,2962,2867,35,89,17,18
54148,445,0,0,drop,70,70,0,1,0,1,0
59792,80,59792,80,allow,33435,1694,31741,43,20,18,25
60646,11392,0,0,deny,66,66,0,1,0,1,0
45552,80,5282,80,allow,890,420,470,14,27,7,7
32768,22,0,0,deny,60,60,0,1,0,1,0
63658,445,0,0,drop,66,66,0,1,0,1,0
65516,53,41111,53,allow,290,94,196,4,40,2,2
56583,53,33992,53,allow,177,94,83,2,29,1,1
38659,443,10582,443,allow,11202,2200,9002,39,131,20,19
49115,443,63602,443,allow,361013,18864,342149,392,296,110,282
49393,445,0,0,drop,66,66,0,1,0,1,0
55146,1433,0,0,deny,60,60,0,1,0,1,0
50254,53,7590,53,allow,749,94,655,2,30,1,1
30188,31063,61312,31063,allow,502,150,352,2,1200,1,1
59789,443,29818,443,allow,103556,8767,94789,144,48,75,69
36483,80,36483,80,allow,1015966,37923,978043,1167,205,468,699
54883,51505,0,0,deny,66,66,0,1,0,1,0
443,31367,0,0,deny,74,74,0,1,0,1,0
50420,80,36435,80,allow,5048,4344,704,11,26,6,5
65165,53,5142,53,allow,177,94,83,2,30,1,1
38306,51221,0,0,deny,62,62,0,1,0,1,0
51952,50967,20758,50967,allow,70,70,0,1,5,1,0
59920,443,3699,443,allow,7359,2050,5309,18,16,10,8
58638,5900,0,0,deny,62,62,0,1,0,1,0
23031,22114,0,0,deny,146,146,0,1,0,1,0
49780,53,4418,53,allow,183,94,89,2,29,1,1
64275,53,2712,53,allow,644,198,446,6,48,3,3
58638,5900,0,0,deny,62,62,0,1,0,1,0
55548,53,25199,53,allow,194,99,95,2,30,1,1
36417,443,64743,443,allow,8611,2046,6565,31,394,10,21
55147,53,9806,53,allow,184,94,90,2,30,1,1
5914,10214,0,0,deny,100,100,0,1,0,1,0
56847,36370,51543,36370,allow,624,318,306,10,15,5,5
58638,5900,58638,5900,allow,126,62,64,2,5,1,1
64106,53,52132,53,allow,195,102,93,2,29,1,1
53820,445,0,0,drop,70,70,0,1,0,1,0
40204,40027,54251,40027,allow,245,182,63,2,30,1,1
60441,64337,24616,64337,allow,70,70,0,1,5,1,0
50390,53,29650,53,allow,772,103,669,2,30,1,1
51467,443,43898,443,allow,186117,12962,173155,249,143,83,166
64605,445,0,0,drop,70,70,0,1,0,1,0
56004,53,27325,53,allow,177,94,83,2,29,1,1
49513,53,36009,53,allow,200,102,98,2,30,1,1
56919,53,40423,53,allow,177,94,83,2,29,1,1
61702,80,48411,80,allow,1553,953,600,14,47,8,6
56724,53,27864,53,allow,182,94,88,2,30,1,1
29049,23,0,0,deny,60,60,0,1,0,1,0
64021,53,21293,53,allow,190,97,93,2,30,1,1
53083,80,12541,80,allow,5259,1904,3355,30,15,23,7
443,62732,0,0,deny,199,199,0,1,0,1,0
49325,443,26750,443,allow,5749,3401,2348,29,76,15,14
31136,50584,0,0,deny,146,146,0,1,0,1,0
55071,53,59621,53,allow,177,94,83,2,30,1,1
64091,80,64091,80,allow,2244,1505,739,11,146,6,5
56719,443,65516,443,allow,7888,1899,5989,20,15,11,9
54653,6881,28676,6881,allow,658,412,246,9,15,5,4
50311,443,61436,443,allow,466,392,74,4,0,3,1
10738,50584,0,0,deny,62,62,0,1,0,1,0
56802,80,23332,80,allow,1559,762,797,14,30,7,7
22856,22114,0,0,deny,66,66,0,1,0,1,0
56937,445,0,0,drop,70,70,0,1,0,1,0
58638,5900,0,0,deny,62,62,0,1,0,1,0
59938,445,0,0,drop,70,70,0,1,0,1,0
2267,53,32602,53,allow,204,118,86,2,30,1,1
14023,37965,0,0,deny,62,62,0,1,0,1,0
55176,53,23799,53,allow,181,94,87,2,30,1,1
62793,445,0,0,drop,70,70,0,1,0,1,0
34366,53,0,0,allow,82,82,0,1,31,1,0
53546,17203,56777,17203,allow,320,140,180,6,7,3,3
1108,47807,0,0,deny,159,159,0,1,0,1,0
56994,53,19050,53,allow,177,94,83,2,30,1,1
56758,40000,5881,40000,allow,70,70,0,1,5,1,0
49359,53,18838,53,allow,216,110,106,2,30,1,1
52062,443,2872,443,allow,61141,52577,8564,102,363,50,52
60762,40010,40997,40010,allow,316,136,180,6,6,3,3
46844,53,0,0,allow,82,82,0,1,31,1,0
53891,1056,54785,1056,allow,260,140,120,5,6,3,2
60786,443,40740,443,allow,12106,2192,9914,38,38,19,19
56754,53,42272,53,allow,209,110,99,2,30,1,1
56205,51505,0,0,deny,66,66,0,1,0,1,0
33200,443,11701,443,allow,67123,10708,56415,100,124,41,59
49408,443,42776,443,allow,4189,2286,1903,35,256,17,18
51666,445,0,0,drop,70,70,0,1,0,1,0
49756,53,28013,53,allow,264,89,175,4,47,2,2
54664,443,18558,443,allow,8263,1279,6984,15,136,7,8
47534,443,60052,443,allow,291717,11752,279965,319,137,123,196
42980,80,62897,80,allow,944,529,415,11,315,6,5
51414,22,0,0,deny,60,60,0,1,0,1,0
65212,53,35167,53,allow,192,98,94,2,31,1,1
59411,37965,0,0,deny,66,66,0,1,0,1,0
55095,53,54084,53,allow,783,96,687,2,30,1,1
1025,35447,0,0,deny,62,62,0,1,0,1,0
64462,445,0,0,drop,70,70,0,1,0,1,0
52731,80,58843,80,allow,1029,567,462,10,17,6,4
19473,51413,49212,51413,allow,459,149,310,2,1200,1,1
52430,445,0,0,drop,70,70,0,1,0,1,0
62235,443,62235,443,allow,16675,2296,14379,37,78,17,20
49418,27018,36116,27018,allow,256,78,178,2,30,1,1
49177,53,24852,53,allow,184,94,90,2,30,1,1
41460,443,23165,443,allow,13890,5926,7964,36,84,20,16
33136,443,16239,443,allow,6648,1556,5092,23,29,13,10
34219,53,25349,53,allow,199,94,105,2,30,1,1
57382,2258,57382,2258,allow,156,156,0,3,8,3,0
54952,5228,14099,5228,allow,12140,3028,9112,54,4653,28,26
5237,30128,2836,30128,allow,621281,256,621025,881,49,5,876
55312,53,10081,53,allow,190,97,93,2,30,1,1
49837,53,39920,53,allow,212,108,104,2,30,1,1
50270,445,0,0,drop,70,70,0,1,0,1,0
50112,123,33230,123,allow,184,94,90,2,30,1,1
39324,64147,0,0,deny,62,62,0,1,0,1,0
35585,53,60283,53,allow,168,78,90,2,29,1,1
51130,61689,0,0,deny,66,66,0,1,0,1,0
56940,80,20270,80,allow,2925,1480,1445,11,30,7,4
51770,445,0,0,drop,70,70,0,1,0,1,0
38460,443,14446,443,allow,272822,10124,262698,330,81,126,204
52645,6881,55258,6881,allow,841,535,306,10,14,5,5
45109,443,9498,443,allow,190,70,120,4,15,2,2
63766,445,0,0,drop,70,70,0,1,0,1,0
51380,445,0,0,drop,66,66,0,1,0,1,0
42155,443,26461,443,allow,70,70,0,1,5,1,0
58638,5900,0,0,deny,62,62,0,1,0,1,0
39062,443,32900,443,allow,11360,8326,3034,36,22,19,17
55476,53,58894,53,allow,232,110,122,2,30,1,1
6712,123,0,0,deny,90,90,0,1,0,1,0
56662,443,60423,443,allow,1233,730,503,12,25,7,5
50779,445,0,0,drop,66,66,0,1,0,1,0
51960,443,28367,443,allow,2648,1797,851,19,23,11,8
56945,53,12864,53,allow,180,94,86,2,30,1,1
64277,53,1694,53,allow,337,110,227,2,30,1,1
34097,443,35195,443,allow,5241,860,4381,17,15,9,8
57075,53,34299,53,allow,212,102,110,2,30,1,1
49465,443,57765,443,allow,11184,6821,4363,27,53,14,13
61886,445,0,0,drop,70,70,0,1,0,1,0
58851,445,0,0,drop,70,70,0,1,0,1,0
53819,445,0,0,drop,66,66,0,1,0,1,0
42144,30170,0,0,deny,146,146,0,1,0,1,0
56664,80,24275,80,allow,1056,682,374,10,15,6,4
55445,445,0,0,drop,66,66,0,1,0,1,0
53225,443,9099,443,allow,6597,1798,4799,28,80,12,16
54078,445,0,0,drop,66,66,0,1,0,1,0
49538,53,45151,53,allow,748,94,654,2,30,1,1
54219,443,4743,443,allow,10323,2834,7489,44,256,21,23
59822,56205,0,0,deny,66,66,0,1,0,1,0
54996,53,2476,53,allow,168,86,82,2,31,1,1
64175,56502,0,0,deny,66,66,0,1,0,1,0
64321,53,14158,53,allow,296,97,199,4,53,2,2
55874,64147,0,0,deny,66,66,0,1,0,1,0
55907,53,18391,53,allow,184,94,90,2,31,1,1
60369,443,60379,443,allow,7939,955,6984,22,107,11,11
49869,53,29655,53,allow,209,110,99,2,30,1,1
49199,53,34176,53,allow,816,102,714,2,30,1,1
60447,36396,16095,36396,allow,70,70,0,2,8,2,0
60894,445,0,0,drop,66,66,0,1,0,1,0
59724,64147,0,0,deny,66,66,0,1,0,1,0
49418,27016,5778,27016,allow,263,78,185,2,29,1,1
19502,53,19502,53,allow,198,89,109,2,31,1,1
50563,37965,0,0,deny,66,66,0,1,0,1,0
6655,2323,0,0,deny,60,60,0,1,0,1,0
52258,445,0,0,drop,70,70,0,1,0,1,0
44847,31105,50353,31105,allow,324,150,174,2,1200,1,1
64622,36829,0,0,deny,66,66,0,1,0,1,0
4788,53,4788,53,allow,825,99,726,2,0,1,1
64709,53,11434,53,allow,821,102,719,2,30,1,1
64988,53,6131,53,allow,360,110,250,2,30,1,1
50228,53,36486,53,allow,173,94,79,2,30,1,1
49445,443,22095,443,allow,462587,17396,445191,527,130,198,329
21839,443,21839,443,allow,13003,1226,11777,25,19,12,13
50990,443,22704,443,allow,6090,2628,3462,21,24,11,10
443,41237,0,0,deny,89,89,0,1,0,1,0
52178,30922,2429,30922,allow,70,70,0,1,5,1,0
62079,30188,0,0,deny,66,66,0,1,0,1,0
56192,445,0,0,drop,66,66,0,1,0,1,0
56110,53,15545,53,allow,508,102,406,2,30,1,1
51676,23718,0,0,deny,66,66,0,1,0,1,0
55551,445,0,0,drop,70,70,0,1,0,1,0
65241,53,47217,53,allow,198,102,96,2,29,1,1
63979,445,0,0,drop,66,66,0,1,0,1,0
42298,40021,40004,40021,allow,148,86,62,2,31,1,1
50727,27029,42555,27029,allow,269,78,191,2,30,1,1
23519,25174,0,0,deny,146,146,0,1,0,1,0
65092,53,51583,53,allow,263,94,169,2,30,1,1
60062,53,61702,53,allow,168,78,90,2,30,1,1
53314,64097,0,0,deny,66,66,0,1,0,1,0
49920,443,27141,443,allow,9759,1989,7770,25,16,13,12
54473,80,28386,80,allow,14035,1381,12654,26,255,14,12
57331,445,0,0,drop,66,66,0,1,0,1,0
50725,445,0,0,drop,66,66,0,1,0,1,0
58215,443,23391,443,allow,7337,1630,5707,23,256,12,11
55326,53,27995,53,allow,177,94,83,2,30,1,1
64330,53,52470,53,allow,193,102,91,2,31,1,1
42465,57470,0,0,deny,60,60,0,1,0,1,0
64137,53,61015,53,allow,216,102,114,2,30,1,1
57957,445,0,0,drop,70,70,0,1,0,1,0
64912,53,24794,53,allow,183,94,89,2,30,1,1
55417,445,0,0,drop,70,70,0,1,0,1,0
53914,443,31627,443,allow,499,425,74,4,0,3,1
31738,51505,0,0,deny,62,62,0,1,0,1,0
56542,53,32612,53,allow,183,94,89,2,31,1,1
62658,445,0,0,drop,70,70,0,1,0,1,0
56797,445,0,0,drop,70,70,0,1,0,1,0
59599,62413,0,0,deny,146,146,0,1,0,1,0
50265,54145,30228,54145,allow,858,858,0,14,1200,14,0
57905,445,0,0,drop,70,70,0,1,0,1,0
63433,445,0,0,drop,70,70,0,1,0,1,0
56361,53,14867,53,allow,193,102,91,2,30,1,1
52604,445,0,0,drop,70,70,0,1,0,1,0
58638,5900,0,0,deny,62,62,0,1,0,1,0
65410,53,40006,53,allow,229,110,119,2,31,1,1
53872,53,43483,53,allow,70,70,0,1,30,1,0
53667,22114,0,0,deny,66,66,0,1,0,1,0
56882,53,12251,53,allow,87,87,0,2,60,2,0
65315,53,25956,53,allow,172,88,84,2,30,1,1
39244,36829,0,0,deny,62,62,0,1,0,1,0
38606,53,21514,53,allow,168,78,90,2,30,1,1
55152,53,27991,53,allow,176,90,86,2,30,1,1
51942,443,54861,443,allow,2646,1322,1324,28,36,15,13
54336,445,0,0,drop,66,66,0,1,0,1,0
49858,53,41757,53,allow,177,94,83,2,30,1,1
55442,53,12898,53,allow,177,94,83,2,30,1,1
44211,53,44211,53,allow,850,114,736,2,30,1,1
53711,80,6435,80,allow,2391,532,1859,11,75,6,5
55273,53,29396,53,allow,167,86,81,2,30,1,1
6882,6889,29221,6889,allow,221,111,110,2,1201,1,1
42172,443,15822,443,allow,7071,1908,5163,29,944,14,15
58028,445,0,0,drop,70,70,0,1,0,1,0
50700,80,4259,80,allow,417,417,0,4,9,4,0
61388,80,19899,80,allow,14158,1392,12766,26,255,14,12
64229,445,0,0,drop,66,66,0,1,0,1,0
51356,22114,0,0,deny,66,66,0,1,0,1,0
49862,53,25145,53,allow,176,90,86,2,30,1,1
51555,443,44960,443,allow,876,390,486,12,39,4,8
2918,37965,0,0,deny,62,62,0,1,0,1,0
53745,443,56954,443,allow,499,425,74,4,0,3,1
443,50755,0,0,deny,102,102,0,1,0,1,0
9219,32480,0,0,deny,72,72,0,1,0,1,0
9129,53,56648,53,allow,205,86,119,2,30,1,1
48098,80,19717,80,allow,1638,1324,314,10,15,5,5
2464,50584,0,0,deny,66,66,0,1,0,1,0
62089,445,0,0,drop,66,66,0,1,0,1,0
51992,22670,31187,22670,allow,70,70,0,1,4,1,0
55933,53,2538,53,allow,180,92,88,2,30,1,1
60136,443,31780,443,allow,21278,12533,8745,57,183,36,21
55829,53,27683,53,allow,177,94,83,2,29,1,1
63028,53,16966,53,allow,384,166,218,2,30,1,1
26048,21,0,0,deny,60,60,0,1,0,1,0
57044,53,35705,53,allow,197,102,95,2,30,1,1
62421,445,0,0,drop,70,70,0,1,0,1,0
53668,50678,10621,50678,allow,70,70,0,1,5,1,0
49503,443,6313,443,allow,20565,2848,17717,31,27,10,21
55234,443,6100,443,allow,9176,2226,6950,28,31,16,12
55934,53,23725,53,allow,182,102,80,2,30,1,1
57173,44847,0,0,deny,62,62,0,1,0,1,0
14309,56205,0,0,deny,146,146,0,1,0,1,0
64279,53,29219,53,allow,177,94,83,2,29,1,1
55921,53,32858,53,allow,177,94,83,2,30,1,1
57241,443,46273,443,allow,1167125,49170,1117955,1459,92,635,824
56455,53,54287,53,allow,183,94,89,2,31,1,1
36628,80,36628,80,allow,5529,713,4816,15,15,8,7
56564,9571,0,0,deny,78,78,0,1,0,1,0
64792,443,39397,443,allow,16199,7657,8542,58,127,28,30
61574,445,0,0,drop,66,66,0,1,0,1,0
55618,53,36676,53,allow,199,94,105,2,30,1,1
55690,443,36462,443,allow,914,444,470,14,29,7,7
36209,443,44738,443,allow,656609,25419,631190,752,62,322,430
50154,53,53091,53,allow,756,95,661,2,30,1,1
63913,445,0,0,drop,70,70,0,1,0,1,0
58442,123,61048,123,allow,184,94,90,2,30,1,1
21365,23718,0,0,deny,62,62,0,1,0,1,0
64852,53,7184,53,allow,248,102,146,2,29,1,1
61761,44847,0,0,deny,66,66,0,1,0,1,0
52603,445,0,0,drop,66,66,0,1,0,1,0
52146,445,0,0,drop,70,70,0,1,0,1,0
61879,445,0,0,drop,70,70,0,1,0,1,0
65445,53,5000,53,allow,718,94,624,2,30,1,1
50819,443,23164,443,allow,1663508,63528,1599980,1853,251,692,1161
49529,443,17894,443,allow,9047,1436,7611,22,27,10,12
55624,53,59892,53,allow,308,101,207,4,53,2,2
62424,445,0,0,drop,66,66,0,1,0,1,0
49964,53,64934,53,allow,749,94,655,2,30,1,1
60538,80,60538,80,allow,318,120,198,6,26,3,3
65289,25174,0,0,deny,66,66,0,1,0,1,0
55402,445,0,0,drop,66,66,0,1,0,1,0
52439,35894,0,0,deny,70,70,0,1,0,1,0
0,0,0,0,deny,210,210,0,3,0,3,0
49191,35440,0,0,deny,62,62,0,1,0,1,0
53154,44645,45393,44645,allow,320,140,180,6,5,3,3
58833,445,0,0,drop,70,70,0,1,0,1,0
36413,443,33262,443,allow,2064683,47545,2017138,1994,33,657,1337
50913,445,0,0,drop,70,70,0,1,0,1,0
57499,80,57499,80,allow,343853,13570,330283,445,3,223,222
64719,445,0,0,drop,70,70,0,1,0,1,0
57843,443,8573,443,allow,25053,19627,5426,38,76,23,15
50052,65008,0,0,deny,60,60,0,1,0,1,0
47147,443,41911,443,allow,5789,952,4837,19,150,10,9
0,0,0,0,allow,156,156,0,2,0,2,0
55337,53,8844,53,allow,198,102,96,2,31,1,1
8191,51221,0,0,deny,62,62,0,1,0,1,0
46590,443,20776,443,allow,6665,1130,5535,24,287,13,11
58398,44847,0,0,deny,66,66,0,1,0,1,0
50938,80,32549,80,allow,10272889,104948,10167941,8416,121,1525,6891
51229,443,49748,443,allow,8590,1038,7552,16,120,7,9
2206,25174,0,0,deny,62,62,0,1,0,1,0
40956,443,7227,443,allow,10836,1733,9103,34,180,15,19
49187,2710,53094,2710,allow,70,70,0,1,5,1,0
50438,50584,0,0,deny,146,146,0,1,0,1,0
57331,53,30032,53,allow,172,94,78,2,30,1,1
61507,445,0,0,drop,70,70,0,1,0,1,0
63464,443,28849,443,allow,3120,976,2144,13,135,6,7
38565,51505,0,0,deny,62,62,0,1,0,1,0
58638,5900,0,0,deny,62,62,0,1,0,1,0
52764,445,0,0,drop,70,70,0,1,0,1,0
55644,45579,20057,45579,allow,70,70,0,1,5,1,0
58638,5900,0,0,deny,62,62,0,1,0,1,0
59599,62413,0,0,deny,62,62,0,1,0,1,0
52838,37965,0,0,deny,66,66,0,1,0,1,0
50916,80,44611,80,allow,11456216,116932,11339284,9298,139,1683,7615
62776,62413,0,0,deny,62,62,0,1,0,1,0
44962,8802,46440,8802,allow,4014,2342,1672,42,386,21,21
64288,53,54415,53,allow,398,103,295,4,41,2,2
63758,443,30040,443,allow,3263,1643,1620,9,119,5,4
49742,53,44369,53,allow,199,94,105,2,30,1,1
50647,445,0,0,drop,70,70,0,1,0,1,0
46451,443,47700,443,allow,350492,17722,332770,449,125,169,280
59181,445,0,0,drop,70,70,0,1,0,1,0
38135,80,24108,80,allow,111328,4904,106424,145,240,66,79
50522,445,0,0,drop,70,70,0,1,0,1,0
43704,465,0,0,deny,60,60,0,1,0,1,0
51431,445,0,0,drop,70,70,0,1,0,1,0
56467,53,49050,53,allow,578,286,292,9,15,5,4
49776,53,49776,53,allow,256,114,142,2,30,1,1
60699,445,0,0,drop,66,66,0,1,0,1,0
19933,35440,0,0,deny,62,62,0,1,0,1,0
49750,445,0,0,drop,66,66,0,1,0,1,0
64201,53,54602,53,allow,434,96,338,4,30,2,2
1053,2310,0,0,deny,148,148,0,1,0,1,0
50584,16455,26852,16455,allow,1356,300,1056,6,1200,3,3
40695,53,6681,53,allow,168,78,90,2,29,1,1
65481,443,11803,443,allow,138507,5990,132517,156,16,60,96
47582,443,49001,443,allow,6214,1733,4481,13,120,6,7
56240,53,50619,53,allow,748,95,653,2,30,1,1
51968,445,0,0,drop,70,70,0,1,0,1,0
52473,445,0,0,drop,66,66,0,1,0,1,0
47010,53,59094,53,allow,294,94,200,2,30,1,1
25961,55783,0,0,deny,60,60,0,1,0,1,0
65424,53,57166,53,allow,210,110,100,2,29,1,1
48817,57451,48817,57451,allow,152,152,0,1,1200,1,0
50284,53,6888,53,allow,168,78,90,2,30,1,1
3584,25174,0,0,deny,62,62,0,1,0,1,0
37026,80,28562,80,allow,2849,1631,1218,9,721,5,4
54687,445,0,0,drop,70,70,0,1,0,1,0
56624,443,34630,443,allow,7940,1951,5989,20,16,11,9
56241,445,0,0,drop,70,70,0,1,0,1,0
46232,53,46232,53,allow,216,90,126,2,30,1,1
53555,445,0,0,drop,66,66,0,1,0,1,0
43129,20220,0,0,deny,62,62,0,1,0,1,0
61536,445,0,0,drop,66,66,0,1,0,1,0
55189,53,54191,53,allow,211,102,109,2,30,1,1
55878,7302,0,0,deny,66,66,0,1,0,1,0
56732,445,0,0,drop,70,70,0,1,0,1,0
56418,80,22380,80,allow,39249,938,38311,40,104,11,29
57071,53,47529,53,allow,274,110,164,2,31,1,1
55185,53,27754,53,allow,758,93,665,2,30,1,1
54389,28543,0,0,deny,66,66,0,1,0,1,0
57557,64147,0,0,deny,66,66,0,1,0,1,0
59930,443,17395,443,allow,58431,5847,52584,55,120,10,45
55482,53,39470,53,allow,199,102,97,2,30,1,1
57879,445,0,0,drop,66,66,0,1,0,1,0
41543,443,50786,443,allow,78,78,0,1,5,1,0
55337,53,58173,53,allow,198,102,96,2,30,1,1
50038,53,24889,53,allow,177,94,83,2,30,1,1
55401,53,24581,53,allow,168,86,82,2,30,1,1
52459,33890,0,0,deny,60,60,0,1,0,1,0
50882,445,0,0,drop,70,70,0,1,0,1,0
56586,53,6320,53,allow,170,87,83,2,30,1,1
30574,64147,0,0,deny,62,62,0,1,0,1,0
56152,53,61194,53,allow,190,97,93,2,31,1,1
55411,53,35188,53,allow,200,94,106,2,30,1,1
28583,22114,0,0,deny,146,146,0,1,0,1,0
55828,53,14283,53,allow,177,94,83,2,30,1,1
32342,62413,0,0,deny,66,66,0,1,0,1,0
51656,80,3808,80,allow,318,192,126,6,37,4,2
64941,53,17276,53,allow,199,102,97,2,30,1,1
50679,443,24042,443,allow,14172,2714,11458,32,637,13,19
49983,53,17295,53,allow,211,110,101,2,31,1,1
44558,443,44558,443,allow,5480,2503,2977,20,15,11,9
49786,25174,0,0,deny,66,66,0,1,0,1,0
51329,445,0,0,drop,70,70,0,1,0,1,0
1888,51505,0,0,deny,62,62,0,1,0,1,0
63963,50584,0,0,deny,66,66,0,1,0,1,0
53721,62413,0,0,deny,62,62,0,1,0,1,0
57029,53,54997,53,allow,413,170,243,6,30,3,3
49604,53,29103,53,allow,89,89,0,1,30,1,0
60462,80,40235,80,allow,1588,553,1035,10,75,6,4
64815,445,0,0,drop,70,70,0,1,0,1,0
59227,445,0,0,drop,70,70,0,1,0,1,0
54048,445,0,0,drop,70,70,0,1,0,1,0
43405,443,52895,443,allow,5977,1326,4651,18,30,11,7
56421,80,51921,80,allow,34300,868,33432,35,104,10,25
14409,7363,0,0,deny,145,145,0,1,0,1,0
59915,42707,0,0,deny,145,145,0,1,0,1,0
63972,53,46168,53,allow,193,102,91,2,30,1,1
55973,53,5208,53,allow,939,678,261,2,30,1,1
55393,44512,0,0,deny,66,66,0,1,0,1,0
53648,31637,13598,31637,allow,744,618,126,10,28,8,2
64749,53,28339,53,allow,199,94,105,2,33,1,1
61936,443,38328,443,allow,4348,1643,2705,14,138,6,8
57371,443,2707,443,allow,5619,927,4692,17,15,10,7
49226,53,7327,53,allow,194,102,92,2,29,1,1
59422,51221,0,0,deny,66,66,0,1,0,1,0
51997,53,57972,53,allow,164,78,86,2,30,1,1
9308,443,57827,443,allow,3837,488,3349,15,15,7,8
55968,56205,0,0,deny,66,66,0,1,0,1,0
64357,53,36127,53,allow,183,94,89,2,30,1,1
51191,26467,0,0,deny,66,66,0,1,0,1,0
62324,443,62324,443,allow,2882,1622,1260,20,86,10,10
58342,445,0,0,drop,70,70,0,1,0,1,0
49790,445,0,0,drop,66,66,0,1,0,1,0
58229,50584,0,0,deny,66,66,0,1,0,1,0
10547,57470,0,0,deny,62,62,0,1,0,1,0
49895,445,0,0,drop,70,70,0,1,0,1,0
51093,57470,0,0,deny,66,66,0,1,0,1,0
50210,53,56208,53,allow,756,94,662,2,29,1,1
56778,35292,48198,35292,allow,70,70,0,1,5,1,0
53964,445,0,0,drop,70,70,0,1,0,1,0
45540,443,45540,443,allow,4702,1795,2907,19,28,11,8
50537,445,0,0,drop,66,66,0,1,0,1,0
52088,35605,27322,35605,allow,70,70,0,1,5,1,0
60386,80,35408,80,allow,214,140,74,4,15,3,1
43271,50584,0,0,deny,146,146,0,1,0,1,0
42231,57470,0,0,deny,78,78,0,1,0,1,0
57514,445,0,0,drop,70,70,0,1,0,1,0
27005,27015,15191,27015,allow,889,126,763,2,30,1,1
39831,443,37659,443,allow,7656,4286,3370,38,86,19,19
65220,53,7048,53,allow,184,94,90,2,29,1,1
57236,443,34862,443,allow,2294,1126,1168,25,120,12,13
55774,8060,26633,8060,allow,70,70,0,2,8,2,0
58638,5900,0,0,deny,62,62,0,1,0,1,0
56644,443,53305,443,allow,3079,1895,1184,18,16,10,8
49299,443,14634,443,allow,6681,1950,4731,24,45,14,10
52096,445,0,0,drop,70,70,0,1,0,1,0
40781,443,17024,443,allow,14327,1918,12409,37,270,17,20
49949,443,7206,443,allow,4712,908,3804,18,89,9,9
60251,445,0,0,drop,70,70,0,1,0,1,0
64320,53,33961,53,allow,198,101,97,2,30,1,1
60374,445,0,0,drop,70,70,0,1,0,1,0
60504,443,51319,443,allow,1875,1165,710,13,28,7,6
65011,53,28977,53,allow,183,94,89,2,31,1,1
27888,53,27888,53,allow,240,96,144,2,31,1,1
55157,7302,0,0,deny,66,66,0,1,0,1,0
49418,29999,25371,29999,allow,244,78,166,2,31,1,1
11136,57587,0,0,deny,62,62,0,1,0,1,0
56652,53,23903,53,allow,821,102,719,2,30,1,1
65374,445,0,0,drop,70,70,0,1,0,1,0
11775,25174,0,0,deny,62,62,0,1,0,1,0
57883,443,47068,443,allow,1786,1147,639,17,177,10,7
57590,53,59223,53,allow,260,86,174,2,30,1,1
50720,445,0,0,drop,66,66,0,1,0,1,0
55817,36829,0,0,deny,66,66,0,1,0,1,0
50411,53,28874,53,allow,86,86,0,1,30,1,0
27337,51505,0,0,deny,62,62,0,1,0,1,0
50461,443,13300,443,allow,78333,12774,65559,140,128,59,81
63452,445,0,0,drop,66,66,0,1,0,1,0
49360,443,11814,443,allow,5782,1008,4774,17,16,8,9
50127,64147,0,0,deny,66,66,0,1,0,1,0
33150,53,60040,53,allow,816,228,588,8,30,4,4
37233,53,50033,53,allow,198,93,105,2,30,1,1
56962,53,51903,53,allow,170,87,83,2,30,1,1
4544,3478,63036,3478,allow,338,110,228,2,299,1,1
54423,21247,0,0,deny,66,66,0,1,0,1,0
49555,53,60187,53,allow,578,286,292,9,15,5,4
50895,443,56217,443,allow,6354,1373,4981,18,129,9,9
62333,443,30059,443,allow,3170,1556,1614,7,121,3,4
53212,443,62292,443,allow,81114,4708,76406,108,66,39,69
6975,26543,0,0,deny,139,139,0,1,0,1,0
22592,443,22592,443,allow,29021,6752,22269,48,30,29,19
6754,443,21695,443,allow,13520,2288,11232,43,192,19,24
44854,26467,0,0,deny,62,62,0,1,0,1,0
57156,445,0,0,drop,70,70,0,1,0,1,0
33822,57470,0,0,deny,66,66,0,1,0,1,0
42119,36237,0,0,deny,66,66,0,1,0,1,0
58822,443,37574,443,allow,5166,700,4466,16,15,7,9
51571,443,51571,443,allow,1724,916,808,17,128,7,10
56455,53,58599,53,allow,183,94,89,2,30,1,1
50191,445,0,0,drop,70,70,0,1,0,1,0
61403,445,0,0,drop,70,70,0,1,0,1,0
53806,443,13248,443,allow,499,425,74,4,0,3,1
49211,15576,30482,15576,allow,70,70,0,1,5,1,0
58638,5900,0,0,deny,62,62,0,1,0,1,0
55376,53,48930,53,allow,789,110,679,2,31,1,1
58509,21247,0,0,deny,66,66,0,1,0,1,0
49988,443,12921,443,allow,214,82,132,4,5,2,2
37965,46008,3180,46008,allow,132,132,0,3,1200,3,0
58858,443,56785,443,allow,7413235,214811,7198424,7869,344,2785,5084
53540,443,65354,443,allow,20948,4141,16807,76,616,37,39
52831,3389,52831,3389,allow,4145,1976,2169,22,18,13,9
48817,45919,48817,45919,allow,334,158,176,2,1200,1,1
51907,80,10230,80,allow,9189,3144,6045,19,28,11,8
56835,53,48670,53,allow,177,94,83,2,30,1,1
19626,3389,19626,3389,reset-both,293,223,70,4,0,3,1
59106,443,57756,443,allow,7398,2209,5189,23,35,11,12
45981,51505,0,0,deny,146,146,0,1,0,1,0
9448,57866,0,0,deny,62,62,0,1,0,1,0
56127,53,8590,53,allow,166,85,81,2,31,1,1
53419,445,0,0,drop,70,70,0,1,0,1,0
45941,23386,0,0,deny,60,60,0,1,0,1,0
58409,445,0,0,drop,66,66,0,1,0,1,0
56498,53,39557,53,allow,199,102,97,2,30,1,1
50546,445,0,0,drop,70,70,0,1,0,1,0
56739,443,41966,443,allow,7914,1925,5989,20,15,11,9
52398,445,0,0,drop,70,70,0,1,0,1,0
51943,53,57117,53,allow,200,86,114,2,30,1,1
41689,443,36583,443,allow,1307513,51701,1255812,1486,148,576,910
42298,40023,34639,40023,allow,1188,567,621,6,31,3,3
63755,53,63755,53,allow,223,92,131,2,31,1,1
63175,445,0,0,drop,70,70,0,1,0,1,0
59441,445,0,0,drop,70,70,0,1,0,1,0
52336,64097,0,0,deny,62,62,0,1,0,1,0
52560,445,0,0,drop,70,70,0,1,0,1,0
60433,443,40567,443,allow,7113,3977,3136,23,136,12,11
49314,443,60912,443,allow,8599,4862,3737,47,195,26,21
60176,445,0,0,drop,70,70,0,1,0,1,0
46772,80,10171,80,allow,2068,1371,697,13,83,7,6
55100,53,57209,53,allow,711,87,624,2,30,1,1
51032,30188,0,0,deny,66,66,0,1,0,1,0
49169,53,65143,53,allow,184,94,90,2,30,1,1
55821,53,40940,53,allow,168,86,82,2,30,1,1
65496,57470,0,0,deny,146,146,0,1,0,1,0
54781,445,0,0,drop,66,66,0,1,0,1,0
45993,443,45993,443,allow,1494,898,596,12,142,6,6
17781,50265,0,0,deny,62,62,0,1,0,1,0
53010,445,0,0,drop,66,66,0,1,0,1,0
63556,445,0,0,drop,70,70,0,1,0,1,0
61731,445,0,0,drop,70,70,0,1,0,1,0
47832,443,4961,443,allow,130090,7064,123026,184,200,92,92
7166,64147,0,0,deny,62,62,0,1,0,1,0
65529,35440,0,0,deny,62,62,0,1,0,1,0
58542,445,0,0,drop,70,70,0,1,0,1,0
42873,443,33511,443,allow,3379,2111,1268,19,15,10,9
63944,8999,41992,8999,allow,70,70,0,1,5,1,0
55999,443,22014,443,allow,3640,606,3034,13,120,6,7
34656,443,55937,443,allow,3521,516,3005,12,15,6,6
42298,40037,29650,40037,allow,208,86,122,4,30,2,2
49418,27015,16562,27015,allow,269,71,198,2,31,1,1
61055,445,0,0,drop,70,70,0,1,0,1,0
50767,445,0,0,drop,66,66,0,1,0,1,0
52589,445,0,0,drop,70,70,0,1,0,1,0
61037,445,0,0,drop,66,66,0,1,0,1,0
59937,37965,0,0,deny,66,66,0,1,0,1,0
45394,443,62065,443,allow,1314,653,661,13,185,7,6
52048,80,14488,80,allow,41486,20844,20642,64,37,32,32
10916,44847,0,0,deny,66,66,0,1,0,1,0
57470,35988,31535,35988,allow,132,132,0,3,1199,3,0
53824,41482,38792,41482,allow,70,70,0,2,8,2,0
56586,445,0,0,drop,70,70,0,1,0,1,0
55310,53,40255,53,allow,168,78,90,2,29,1,1
56568,445,0,0,drop,70,70,0,1,0,1,0
65485,53,26521,53,allow,184,94,90,2,31,1,1
49103,443,44063,443,allow,6725,505,6220,20,181,5,15
49611,53,47629,53,allow,184,94,90,2,29,1,1
56730,53,53565,53,allow,210,110,100,2,30,1,1
51505,445,0,0,drop,66,66,0,1,0,1,0
57493,443,0,0,deny,60,60,0,1,0,1,0
1025,50584,0,0,deny,146,146,0,1,0,1,0
59282,80,59282,80,allow,181627,17128,164499,277,15,79,198
49206,53,42939,53,allow,179,94,85,2,31,1,1
47595,33440,0,0,allow,106,106,0,1,61,1,0
49606,53,17957,53,allow,258,110,148,2,30,1,1
52988,53567,0,0,deny,62,62,0,1,0,1,0
993,33264,0,0,deny,66,66,0,1,0,1,0
29139,64147,0,0,deny,62,62,0,1,0,1,0
64320,53,39088,53,allow,197,94,103,2,29,1,1
63926,445,0,0,drop,66,66,0,1,0,1,0
50542,445,0,0,drop,66,66,0,1,0,1,0
52040,2524,8539,2524,allow,70,70,0,2,7,2,0
55005,53,64520,53,allow,183,94,89,2,30,1,1
59128,44847,0,0,deny,62,62,0,1,0,1,0
57131,31061,0,0,deny,145,145,0,1,0,1,0
62325,443,62325,443,allow,1210,637,573,14,51,7,7
55672,45682,1314,45682,allow,70,70,0,1,5,1,0
51929,53371,7224,53371,allow,70,70,0,2,8,2,0
39430,443,21846,443,allow,506,292,214,8,50,5,3
50578,80,50578,80,allow,35580,13335,22245,69,23,38,31
57676,64147,0,0,deny,74,74,0,1,0,1,0
55664,445,0,0,drop,70,70,0,1,0,1,0
57355,443,34540,443,allow,16483,8545,7938,40,281,21,19
53240,443,16717,443,allow,1296713,27754,1268959,1253,118,366,887
52083,445,0,0,drop,70,70,0,1,0,1,0
64749,3389,64749,3389,allow,3347,1458,1889,15,18,8,7
62915,993,36226,993,allow,8257,4187,4070,70,43,42,28
33730,443,53132,443,allow,5947,1579,4368,22,315,12,10
60883,64147,0,0,deny,74,74,0,1,0,1,0
56256,80,30485,80,allow,25043,1750,23293,44,30,23,21
57853,64147,0,0,deny,66,66,0,1,0,1,0
55252,445,0,0,drop,70,70,0,1,0,1,0
49435,443,3627,443,allow,10377,3140,7237,23,52,11,12
55233,53,15536,53,allow,215,102,113,2,30,1,1
1035,26467,0,0,deny,62,62,0,1,0,1,0
59893,53,45221,53,allow,198,93,105,2,30,1,1
54326,27054,42842,27054,allow,924,924,0,3,30,3,0
53100,443,19603,443,allow,472,406,66,4,0,3,1
53790,443,36167,443,allow,499,425,74,4,0,3,1
38700,443,49227,443,allow,130,70,60,2,14,1,1
61419,57470,0,0,deny,66,66,0,1,0,1,0
55084,443,37269,443,allow,5556,1438,4118,22,196,12,10
49163,36069,48102,36069,allow,5990,5698,292,17,51,14,3
65330,445,0,0,drop,70,70,0,1,0,1,0
62468,445,0,0,drop,70,70,0,1,0,1,0
54530,46776,0,0,deny,66,66,0,1,0,1,0
53472,445,0,0,drop,70,70,0,1,0,1,0
60491,38789,32066,38789,allow,320,140,180,6,7,3,3
50734,37965,0,0,deny,62,62,0,1,0,1,0
29178,35440,0,0,deny,66,66,0,1,0,1,0
54978,53,3492,53,allow,198,94,104,2,30,1,1
46362,35440,0,0,deny,66,66,0,1,0,1,0
65379,443,37475,443,allow,76625,63648,12977,139,83,79,60
56771,53,26360,53,allow,193,102,91,2,31,1,1
50978,80,46474,80,allow,1442,700,742,12,35,6,6
49717,57470,0,0,deny,62,62,0,1,0,1,0
62101,445,0,0,drop,70,70,0,1,0,1,0
62763,443,43714,443,allow,7755,4481,3274,17,135,9,8
443,28417,0,0,deny,82,82,0,1,0,1,0
49858,443,16431,443,allow,2027955,75406,1952549,2104,60,564,1540
50570,80,64078,80,allow,318,192,126,6,26,4,2
64867,53,35181,53,allow,184,86,98,2,30,1,1
42890,80,22504,80,allow,2030,586,1444,10,30,6,4
50423,445,0,0,drop,70,70,0,1,0,1,0
65419,26467,0,0,deny,62,62,0,1,0,1,0
26752,64147,0,0,deny,62,62,0,1,0,1,0
37559,443,47158,443,allow,9845,2815,7030,26,37,15,11
51271,37965,0,0,deny,66,66,0,1,0,1,0
1025,35447,0,0,deny,62,62,0,1,0,1,0
63580,443,12197,443,allow,5759,1721,4038,20,78,11,9
57131,35776,0,0,deny,145,145,0,1,0,1,0
57924,445,0,0,drop,66,66,0,1,0,1,0
60517,53,55123,53,allow,215,94,121,2,29,1,1
64214,25174,0,0,deny,66,66,0,1,0,1,0
58761,445,0,0,drop,66,66,0,1,0,1,0
42065,53,0,0,allow,86,86,0,1,30,1,0
43700,30188,0,0,deny,62,62,0,1,0,1,0
50923,445,0,0,drop,66,66,0,1,0,1,0
50623,443,54546,443,allow,13392,11220,2172,31,53,19,12
59952,445,0,0,drop,70,70,0,1,0,1,0
59781,443,23445,443,allow,546,180,366,10,28,4,6
55450,64147,0,0,deny,66,66,0,1,0,1,0
51292,445,0,0,drop,70,70,0,1,0,1,0
56922,445,0,0,drop,70,70,0,1,0,1,0
64821,53,30415,53,allow,775,102,673,2,30,1,1
30920,64147,0,0,deny,62,62,0,1,0,1,0
53535,1393,14227,1393,allow,70,70,0,1,5,1,0
27416,53,27416,53,allow,214,82,132,2,32,1,1
55046,443,8809,443,allow,23425,10763,12662,57,48,31,26
10540,25174,0,0,deny,146,146,0,1,0,1,0
65165,445,0,0,drop,66,66,0,1,0,1,0
51992,443,50696,443,allow,1083,596,487,11,16,7,4
58372,445,0,0,drop,70,70,0,1,0,1,0
65216,53,41251,53,allow,292,94,198,2,30,1,1
51485,445,0,0,drop,70,70,0,1,0,1,0
57470,50321,60490,50321,allow,5231,5231,0,79,5173,79,0
18203,23,0,0,deny,60,60,0,1,0,1,0
50691,443,45100,443,allow,152,86,66,2,6,1,1
54644,443,43384,443,allow,4679,3387,1292,18,304,10,8
58397,445,0,0,drop,70,70,0,1,0,1,0
58805,53,42120,53,allow,237,86,151,2,30,1,1
65270,3855,0,0,deny,78,78,0,1,0,1,0
27005,27015,30434,27015,allow,877,126,751,2,30,1,1
50562,445,0,0,drop,66,66,0,1,0,1,0
38581,22114,0,0,deny,146,146,0,1,0,1,0
55596,53,19558,53,allow,177,94,83,2,30,1,1
64504,445,0,0,drop,70,70,0,1,0,1,0
49761,445,0,0,drop,70,70,0,1,0,1,0
61616,445,0,0,drop,70,70,0,1,0,1,0
443,14315,0,0,deny,158,158,0,1,0,1,0
52946,445,0,0,drop,70,70,0,1,0,1,0
1024,64147,0,0,deny,62,62,0,1,0,1,0
38725,80,37134,80,allow,130,70,60,2,15,1,1
80,34539,80,34539,allow,1468,1468,0,1,5,1,0
56809,53,37625,53,allow,167,86,81,2,30,1,1
50548,445,0,0,drop,66,66,0,1,0,1,0
64985,53,34087,53,allow,194,102,92,2,30,1,1
51999,34619,53326,34619,allow,70,70,0,1,5,1,0
65469,53,59478,53,allow,190,97,93,2,30,1,1
58468,37965,0,0,deny,66,66,0,1,0,1,0
34767,443,6327,443,allow,6313,1368,4945,21,846,11,10
61150,11392,0,0,deny,62,62,0,1,0,1,0
52124,11296,17277,11296,allow,70,70,0,2,8,2,0
49289,53,16244,53,allow,177,94,83,2,30,1,1
48327,57470,0,0,deny,145,145,0,1,0,1,0
49577,443,34979,443,allow,6947,833,6114,20,53,9,11
53128,29593,52824,29593,allow,70,70,0,1,4,1,0
49782,445,0,0,drop,70,70,0,1,0,1,0
49544,53,31008,53,allow,226,86,140,2,30,1,1
58638,5900,0,0,deny,62,62,0,1,0,1,0
50207,445,0,0,drop,70,70,0,1,0,1,0
48068,443,12098,443,allow,10418,1427,8991,27,16,12,15
34932,38608,0,0,deny,62,62,0,1,0,1,0
51295,80,40456,80,allow,6702,5879,823,19,135,10,9
34466,443,32529,443,allow,1402,910,492,11,360,6,5
58987,443,9430,443,allow,3730,2378,1352,23,28,12,11
49761,53,10383,53,allow,182,93,89,2,31,1,1
58862,443,26650,443,allow,5167,700,4467,16,15,7,9
53922,42285,39226,42285,allow,70,70,0,2,8,2,0
4760,44847,0,0,deny,62,62,0,1,0,1,0
51186,445,0,0,drop,66,66,0,1,0,1,0
13179,57866,0,0,deny,62,62,0,1,0,1,0
65106,53,60145,53,allow,438,180,258,6,30,3,3
3978,35440,0,0,deny,62,62,0,1,0,1,0
55101,53,3206,53,allow,711,87,624,2,30,1,1
56939,445,0,0,drop,70,70,0,1,0,1,0
56627,443,11832,443,allow,7889,1900,5989,20,15,11,9
52625,445,0,0,drop,70,70,0,1,0,1,0
48676,53395,0,0,deny,60,60,0,1,0,1,0
49191,51253,24345,51253,allow,504,318,186,8,15,5,3
8592,35993,0,0,deny,62,62,0,1,0,1,0
11541,40108,0,0,deny,148,148,0,1,0,1,0
62236,445,0,0,drop,66,66,0,1,0,1,0
52667,80,52667,80,allow,2011,1422,589,12,48,6,6
80,53945,0,0,deny,60,60,0,1,0,1,0
58524,445,0,0,drop,70,70,0,1,0,1,0
55675,53,17939,53,allow,190,97,93,2,0,1,1
64540,53,45439,53,allow,179,94,85,2,30,1,1
51023,443,24793,443,allow,26189,8238,17951,72,18,39,33
63428,445,0,0,drop,70,70,0,1,0,1,0
17750,30022,45838,30022,allow,481,150,331,2,1200,1,1
5588,5588,0,0,allow,3354,1792,1562,46,195,23,23
60524,443,60524,443,allow,1088,641,447,10,26,6,4
53243,57470,0,0,deny,74,74,0,1,0,1,0
59431,443,29795,443,allow,12756,3596,9160,31,299,16,15
49696,53,9591,53,allow,178,94,84,2,30,1,1
65361,53,22669,53,allow,249,94,155,2,30,1,1
61453,443,29702,443,allow,8052,1307,6745,27,125,16,11
11816,50584,0,0,deny,62,62,0,1,0,1,0
57335,53,58927,53,allow,177,94,83,2,30,1,1
57334,53,51470,53,allow,184,94,90,2,29,1,1
65231,445,0,0,drop,70,70,0,1,0,1,0
34731,22114,0,0,deny,146,146,0,1,0,1,0
55717,445,0,0,drop,70,70,0,1,0,1,0
53825,58968,28988,58968,allow,70,70,0,2,7,2,0
50707,445,0,0,drop,70,70,0,1,0,1,0
51935,38639,36468,38639,allow,70,70,0,1,5,1,0
48350,57470,0,0,deny,74,74,0,1,0,1,0
56788,53,30869,53,allow,199,102,97,2,30,1,1
60426,25988,33152,25988,allow,70,70,0,1,5,1,0
60838,445,0,0,drop,70,70,0,1,0,1,0
53012,51050,0,0,deny,66,66,0,1,0,1,0
58638,5900,0,0,deny,62,62,0,1,0,1,0
55869,53,59798,53,allow,192,98,94,2,30,1,1
30111,2323,0,0,deny,60,60,0,1,0,1,0
47310,443,33854,443,allow,3541,616,2925,19,165,8,11
37645,443,51983,443,allow,23266,18300,4966,56,27,33,23
52096,55854,62191,55854,allow,70,70,0,1,5,1,0
52925,64147,0,0,deny,62,62,0,1,0,1,0
51905,65253,44295,65253,allow,66,66,0,1,5,1,0
53874,443,50535,443,allow,499,425,74,4,1,3,1
50271,445,0,0,drop,70,70,0,1,0,1,0
53788,53,27955,53,allow,213,78,135,2,30,1,1
44062,443,39025,443,allow,4614,853,3761,16,127,9,7
27005,26258,3792,26258,allow,886,126,760,2,31,1,1
52441,53,0,0,allow,86,86,0,1,30,1,0
60105,445,0,0,drop,70,70,0,1,0,1,0
49662,445,0,0,drop,70,70,0,1,0,1,0
40042,80,40042,80,allow,1919,1470,449,10,20,6,4
65348,53,40565,53,allow,177,94,83,2,30,1,1
53433,445,0,0,drop,70,70,0,1,0,1,0
64235,445,0,0,drop,66,66,0,1,0,1,0
53894,2944,38557,2944,allow,70,70,0,1,5,1,0
61503,443,25661,443,allow,182448,3931,178517,161,26,36,125
62980,445,0,0,drop,70,70,0,1,0,1,0
50466,80,50466,80,allow,78335,7114,71221,114,22,60,54
55615,445,0,0,deny,70,70,0,1,0,1,0
56342,443,42448,443,allow,1463,988,475,12,27,7,5
51953,62964,9503,62964,allow,316,136,180,6,5,3,3
50828,123,0,0,deny,234,234,0,1,0,1,0
56273,53,51229,53,allow,197,102,95,2,33,1,1
64410,445,0,0,drop,70,70,0,1,0,1,0
64180,445,0,0,drop,70,70,0,1,0,1,0
56827,53,30639,53,allow,195,102,93,2,29,1,1
62892,443,62892,443,allow,4377,1470,2907,19,30,11,8
53548,445,0,0,drop,70,70,0,1,0,1,0
49415,53,54397,53,allow,188,96,92,2,31,1,1
43025,443,51895,443,allow,25223,13115,12108,63,116,33,30
53122,443,25117,443,allow,23067,5901,17166,43,73,21,22
50902,80,26223,80,allow,12578792,132594,12446198,10198,133,1845,8353
51090,445,0,0,drop,70,70,0,1,0,1,0
58361,443,12659,443,allow,7297,2046,5251,22,29,13,9
49294,53,26484,53,allow,723,102,621,2,30,1,1
49978,53,13448,53,allow,190,97,93,2,30,1,1
49925,443,37960,443,allow,19134,7361,11773,40,148,19,21
56314,53,50014,53,allow,183,94,89,2,30,1,1
59743,445,0,0,drop,66,66,0,1,0,1,0
51100,80,29611,80,allow,12300,4454,7846,26,30,13,13
50085,80,7079,80,allow,3326,684,2642,12,15,7,5
25363,23,0,0,deny,60,60,0,1,0,1,0
2267,53,32396,53,allow,204,118,86,2,30,1,1
1638,22114,0,0,deny,62,62,0,1,0,1,0
61464,80,54948,80,allow,366,180,186,7,93,4,3
48817,10528,48817,10528,allow,2736,1992,744,37,1580,25,12
16430,31573,0,0,deny,62,62,0,1,0,1,0
35085,443,56294,443,allow,1617,1062,555,13,45,8,5
39716,53,15462,53,allow,86,86,0,1,30,1,0
50462,80,37104,80,allow,113965,10014,103951,154,204,65,89
64084,445,0,0,drop,66,66,0,1,0,1,0
32137,44512,0,0,deny,62,62,0,1,0,1,0
2476,6881,0,0,deny,62,62,0,1,0,1,0
52673,80,57831,80,allow,23776,1372,22404,35,112,15,20
61764,445,0,0,drop,70,70,0,1,0,1,0
62776,62413,0,0,deny,62,62,0,1,0,1,0
51550,443,50088,443,allow,13331,2421,10910,38,209,20,18
45941,23386,0,0,deny,60,60,0,1,0,1,0
33292,50584,0,0,deny,62,62,0,1,0,1,0
55059,445,0,0,drop,70,70,0,1,0,1,0
0,0,0,0,deny,60,60,0,1,0,1,0
56793,53,43867,53,allow,196,102,94,2,30,1,1
52099,28401,4027,28401,allow,70,70,0,2,8,2,0
54963,53,30866,53,allow,210,110,100,2,30,1,1
55469,443,55469,443,allow,4579,1672,2907,19,29,11,8
57238,53,58179,53,allow,165,86,79,2,30,1,1
55032,53,0,0,allow,288,79,209,2,31,1,1
55744,80,6834,80,allow,5146,3694,1452,20,249,10,10
57419,53,24851,53,allow,326,110,216,2,29,1,1
56092,53,34391,53,allow,177,94,83,2,30,1,1
62155,445,0,0,drop,66,66,0,1,0,1,0
56869,17637,0,0,deny,66,66,0,1,0,1,0
53525,34759,11727,34759,allow,70,70,0,1,5,1,0
39435,443,17310,443,allow,2403265,93626,2309639,2795,243,1103,1692
40500,5618,0,0,reset-both,146,146,0,1,0,1,0
64622,445,0,0,drop,66,66,0,1,0,1,0
58005,80,36908,80,allow,14927,10571,4356,39,75,20,19
57547,445,0,0,drop,66,66,0,1,0,1,0
49474,443,32026,443,allow,10315,2018,8297,24,158,12,12
14618,6881,0,0,deny,66,66,0,1,0,1,0
49727,443,58320,443,allow,4116,972,3144,15,50,8,7
3270,35440,0,0,deny,66,66,0,1,0,1,0
34340,443,16904,443,allow,3497,1845,1652,18,16,9,9
65251,53,19717,53,allow,819,102,717,2,30,1,1
59518,80,10090,80,allow,14862,1091,13771,26,135,14,12
55655,53,43785,53,allow,754,94,660,2,31,1,1
59815,443,31852,443,allow,4586,955,3631,17,28,9,8
55701,55777,0,0,deny,62,62,0,1,0,1,0
56751,32300,2097,32300,allow,70,70,0,1,5,1,0
43536,443,9827,443,allow,13710,4975,8735,22,121,9,13
27005,27015,60376,27015,allow,878,126,752,2,30,1,1
56717,445,0,0,drop,70,70,0,1,0,1,0
50567,443,16036,443,allow,5866,1781,4085,21,81,12,9
59486,80,17490,80,allow,882,527,355,10,255,6,4
52060,443,18866,443,allow,40726,3421,37305,52,121,20,32
64044,21989,15782,21989,allow,816,508,308,12,27,7,5
50137,53,58176,53,allow,183,94,89,2,29,1,1
7210,22114,0,0,deny,66,66,0,1,0,1,0
53558,445,0,0,drop,66,66,0,1,0,1,0
52334,443,32129,443,allow,96091,8340,87751,159,205,75,84
1027,23684,0,0,deny,159,159,0,1,0,1,0
60758,53,57238,53,allow,199,94,105,2,30,1,1
55711,53,33941,53,allow,733,93,640,2,31,1,1
63248,445,0,0,drop,70,70,0,1,0,1,0
64995,53,18804,53,allow,204,104,100,2,31,1,1
24270,53,24270,53,allow,825,99,726,2,30,1,1
57629,445,0,0,drop,70,70,0,1,0,1,0
47422,80,55452,80,allow,1614,1300,314,10,18,5,5
56572,53,50763,53,allow,438,180,258,6,30,3,3
54712,443,60548,443,allow,5158,2609,2549,11,121,6,5
59381,53,5162,53,allow,189,78,111,2,30,1,1
63873,44847,0,0,deny,62,62,0,1,0,1,0
54377,56205,0,0,deny,62,62,0,1,0,1,0
53150,445,0,0,drop,70,70,0,1,0,1,0
56327,44512,0,0,deny,66,66,0,1,0,1,0
46758,123,10814,123,allow,184,94,90,2,30,1,1
38634,443,57626,443,allow,9398,4241,5157,22,135,11,11
42792,443,30288,443,allow,7102,1857,5245,28,95,15,13
55991,53,9133,53,allow,199,102,97,2,30,1,1
53808,56215,4312,56215,allow,70,70,0,1,4,1,0
50204,445,0,0,drop,70,70,0,1,0,1,0
45141,443,63115,443,allow,4497,2208,2289,15,137,7,8
64266,53,43619,53,allow,168,86,82,2,30,1,1
55246,445,0,0,drop,66,66,0,1,0,1,0
56552,53,47161,53,allow,195,102,93,2,29,1,1
51521,443,51521,443,allow,138679,4142,134537,141,173,33,108
56726,443,29318,443,allow,7941,1952,5989,20,15,11,9
57912,443,57912,443,allow,4559,1652,2907,19,27,11,8
55059,80,26318,80,allow,306,180,126,6,26,4,2
55605,27274,9607,27274,allow,130,70,60,2,4,1,1
6881,8999,10252,8999,allow,502,150,352,2,1199,1,1
59879,55783,0,0,deny,66,66,0,1,0,1,0
56475,80,2240,80,allow,36057,2080,33977,45,134,19,26
49650,443,26849,443,allow,92597,47158,45439,747,1187,422,325
56742,445,0,0,drop,70,70,0,1,0,1,0
58914,37965,0,0,deny,66,66,0,1,0,1,0
56453,53,58094,53,allow,243,94,149,2,30,1,1
57188,53,44023,53,allow,186,95,91,2,30,1,1
46965,53,4424,53,allow,199,94,105,2,30,1,1
5912,22114,0,0,deny,62,62,0,1,0,1,0
55644,445,0,0,drop,70,70,0,1,0,1,0
64326,445,0,0,drop,70,70,0,1,0,1,0
53460,443,38830,443,allow,25079,5739,19340,39,337,18,21
64715,53,13561,53,allow,770,102,668,2,30,1,1
53640,25174,0,0,deny,66,66,0,1,0,1,0
60602,5222,39358,5222,allow,5564,2206,3358,50,310,20,30
60857,445,0,0,drop,70,70,0,1,0,1,0
65332,56205,0,0,deny,62,62,0,1,0,1,0
55995,53,56863,53,allow,182,94,88,2,30,1,1
57000,80,51268,80,allow,214,140,74,4,35,3,1
55354,53,21132,53,allow,214,110,104,2,30,1,1
59128,445,0,0,drop,66,66,0,1,0,1,0
30960,45691,5004,45691,allow,330,330,0,6,3609,6,0
34539,80,34539,80,allow,22098,1602,20496,24,57,6,18
52340,22114,0,0,deny,66,66,0,1,0,1,0
49837,53,3661,53,allow,183,102,81,2,30,1,1
59364,44847,0,0,deny,66,66,0,1,0,1,0
0,0,0,0,allow,480,244,236,4,0,2,2
53035,443,43721,443,allow,3473,881,2592,13,121,6,7
51272,12210,19987,12210,allow,70,70,0,2,8,2,0
53145,27067,38874,27067,allow,1231702,397859,833843,10382,185,4780,5602
64694,445,0,0,drop,70,70,0,1,0,1,0
60222,80,61233,80,allow,1989,1365,624,11,151,6,5
64732,53,44138,53,allow,189,102,87,2,29,1,1
57654,35440,0,0,deny,66,66,0,1,0,1,0
56419,80,4193,80,allow,34098,808,33290,34,104,9,25
63241,445,0,0,drop,66,66,0,1,0,1,0
50452,80,41109,80,allow,318,192,126,6,29,4,2
56622,53,10987,53,allow,214,110,104,2,30,1,1
52126,80,5898,80,allow,3592,2098,1494,26,417,14,12
59470,53,45081,53,allow,184,86,98,2,29,1,1
56381,25174,0,0,deny,62,62,0,1,0,1,0
65340,53,10565,53,allow,226,102,124,2,30,1,1
62577,445,0,0,drop,70,70,0,1,0,1,0
50578,123,63477,123,allow,184,94,90,2,30,1,1
39166,53,0,0,allow,82,82,0,1,31,1,0
49643,445,0,0,drop,70,70,0,1,0,1,0
61846,445,0,0,drop,70,70,0,1,0,1,0
58843,445,0,0,drop,66,66,0,1,0,1,0
55236,53,57748,53,allow,216,102,114,2,30,1,1
62328,443,62328,443,allow,1210,637,573,14,51,7,7
65119,53,47223,53,allow,568,188,380,6,60,3,3
56661,443,39690,443,allow,7900,3324,4576,28,139,13,15
63953,445,0,0,drop,66,66,0,1,0,1,0
57022,80,30750,80,allow,77115,5003,72112,110,35,56,54
59017,445,0,0,drop,70,70,0,1,0,1,0
65449,53,42820,53,allow,723,102,621,2,30,1,1
53565,443,13839,443,allow,12007,942,11065,19,120,8,11
50569,443,18328,443,allow,5941,1856,4085,22,81,13,9
45359,443,22644,443,allow,10480,4949,5531,22,15,12,10
58638,5900,0,0,deny,62,62,0,1,0,1,0
49926,80,8028,80,allow,1126,609,517,11,15,6,5
58424,52700,0,0,deny,66,66,0,1,0,1,0
50603,443,4652,443,allow,3443,2189,1254,23,72,13,10
56137,53,23667,53,allow,199,102,97,2,31,1,1
57431,53,32621,53,allow,178,91,87,2,31,1,1
56562,443,49879,443,allow,8821,3228,5593,25,60,15,10
61630,445,0,0,drop,66,66,0,1,0,1,0
64534,53,57803,53,allow,214,110,104,2,30,1,1
51605,443,15283,443,allow,4343,2350,1993,17,36,9,8
3478,61463,0,0,deny,933,933,0,1,0,1,0
0,0,0,0,allow,200,102,98,2,0,1,1
37989,49152,16381,49152,allow,156,156,0,3,8,3,0
46140,443,48726,443,allow,172,172,0,2,5,2,0
38171,443,40043,443,allow,1649,980,669,14,28,7,7
443,41545,0,0,deny,60,60,0,1,0,1,0
56134,53,5515,53,allow,183,94,89,2,29,1,1
61945,48817,0,0,deny,62,62,0,1,0,1,0
43039,53,37075,53,allow,241,78,163,2,30,1,1
49273,53,17508,53,allow,342,110,232,2,30,1,1
53725,57418,1375,57418,allow,70,70,0,2,8,2,0
64016,53,54267,53,allow,183,94,89,2,30,1,1
60282,445,0,0,drop,70,70,0,1,0,1,0
55641,61762,32816,61762,allow,70,70,0,2,8,2,0
49259,53,28989,53,allow,168,86,82,2,30,1,1
61002,37965,0,0,deny,145,145,0,1,0,1,0
29245,80,29245,80,allow,27233,4047,23186,44,27,20,24
60048,445,0,0,drop,70,70,0,1,0,1,0
52327,53,21249,53,allow,224,94,130,2,29,1,1
57321,53,34343,53,allow,762,98,664,2,30,1,1
49163,53,24237,53,allow,166,85,81,2,30,1,1
53706,445,0,0,drop,70,70,0,1,0,1,0
56817,48650,23825,48650,allow,130,70,60,2,5,1,1
52108,80,27420,80,allow,182,60,122,4,25,2,2
56799,443,31346,443,allow,6496,1340,5156,31,506,10,21
9330,443,63077,443,allow,3255,430,2825,11,15,6,5
40082,22,0,0,deny,60,60,0,1,0,1,0
46899,443,58934,443,allow,9085,2222,6863,39,125,19,20
64251,53,6102,53,allow,177,94,83,2,30,1,1
61740,443,6060,443,allow,92202,65396,26806,193,3454,68,125
58373,443,64061,443,allow,78832,12408,66424,109,162,46,63
59668,50584,0,0,deny,66,66,0,1,0,1,0
60520,53,60520,53,allow,248,106,142,2,29,1,1
5462,21247,0,0,deny,66,66,0,1,0,1,0
59248,443,51315,443,allow,8332,1024,7308,21,25,11,10
49492,53,34957,53,allow,199,102,97,2,31,1,1
59635,7275,39827,7275,allow,448,78,370,6,25,1,5
38681,15503,0,0,deny,74,74,0,1,0,1,0
55534,53,6633,53,allow,86,86,0,1,30,1,0
58131,445,0,0,drop,70,70,0,1,0,1,0
10019,443,53412,443,allow,1497912,26236,1471676,1321,121,299,1022
57711,445,0,0,drop,70,70,0,1,0,1,0
11478,51221,0,0,deny,66,66,0,1,0,1,0
56439,53,20721,53,allow,177,94,83,2,29,1,1
55974,53,19851,53,allow,762,98,664,2,30,1,1
60471,445,0,0,drop,70,70,0,1,0,1,0
58875,53,56659,53,allow,370,86,284,2,30,1,1
16387,44427,0,0,deny,60,60,0,1,0,1,0
63809,45193,55077,45193,allow,66,66,0,1,5,1,0
53278,443,21560,443,allow,38395,6930,31465,56,30,27,29
9238,80,17779,80,allow,378,192,186,7,26,4,3
52415,445,0,0,drop,66,66,0,1,0,1,0
48978,25174,0,0,deny,66,66,0,1,0,1,0
51108,80,61739,80,allow,6504,3994,2510,26,47,14,12
51486,445,0,0,drop,70,70,0,1,0,1,0
55896,53,50702,53,allow,184,94,90,2,31,1,1
59227,11392,0,0,deny,62,62,0,1,0,1,0
63820,27441,46760,27441,allow,70,70,0,1,4,1,0
40086,22114,0,0,deny,146,146,0,1,0,1,0
39630,443,32291,443,allow,70,70,0,1,5,1,0
45863,53,45863,53,allow,229,90,139,2,30,1,1
50017,3389,50017,3389,allow,3428,1714,1714,16,34,8,8
55141,53,24444,53,allow,184,94,90,2,30,1,1
56504,53,24881,53,allow,198,102,96,2,32,1,1
61315,48817,0,0,deny,62,62,0,1,0,1,0
36276,7000,36276,7000,allow,3638,2027,1611,17,15,9,8
57149,53,45353,53,allow,222,86,136,2,30,1,1
57236,53733,0,0,deny,66,66,0,1,0,1,0
50634,443,27378,443,allow,8220,1670,6550,26,71,13,13
65028,445,0,0,drop,70,70,0,1,0,1,0
62080,54532,0,0,deny,60,60,0,1,0,1,0
19394,44847,0,0,deny,66,66,0,1,0,1,0
58081,3389,58081,3389,allow,3549,1594,1955,18,16,10,8
64172,53,13713,53,allow,197,102,95,2,29,1,1
50939,443,29204,443,allow,134,60,74,3,5,2,1
60430,51413,63647,51413,allow,70,70,0,2,8,2,0
6881,6883,20913,6883,allow,259,150,109,2,1200,1,1
55998,445,0,0,drop,66,66,0,1,0,1,0
49395,445,0,0,drop,70,70,0,1,0,1,0
52265,32078,35097,32078,allow,70,70,0,2,7,2,0
50757,64147,0,0,deny,66,66,0,1,0,1,0
55082,53,13671,53,allow,755,93,662,2,31,1,1
64066,23718,0,0,deny,62,62,0,1,0,1,0
57002,53,39237,53,allow,211,94,117,2,30,1,1
56808,53,42088,53,allow,180,94,86,2,35,1,1
37965,33622,23125,33622,allow,132,132,0,3,1199,3,0
57228,53,47428,53,allow,199,102,97,2,30,1,1
44805,3389,44805,3389,allow,4870,2631,2239,23,19,13,10
64743,445,0,0,drop,70,70,0,1,0,1,0
49633,53,11968,53,allow,168,86,82,2,30,1,1
64169,53,31527,53,allow,209,110,99,2,30,1,1
52690,7302,0,0,deny,66,66,0,1,0,1,0
26799,6881,0,0,deny,62,62,0,1,0,1,0
61830,445,0,0,drop,70,70,0,1,0,1,0
49209,53,10202,53,allow,198,101,97,2,31,1,1
10089,80,55892,80,allow,130,70,60,2,15,1,1
49162,53,33354,53,allow,183,94,89,2,30,1,1
40959,61903,0,0,deny,145,145,0,1,0,1,0
50006,53,41506,53,allow,994,86,908,2,29,1,1
50553,445,0,0,drop,66,66,0,1,0,1,0
27505,25174,0,0,deny,62,62,0,1,0,1,0
59744,445,0,0,drop,66,66,0,1,0,1,0
54698,445,0,0,drop,66,66,0,1,0,1,0
49445,445,0,0,drop,70,70,0,1,0,1,0
56445,53,12217,53,allow,711,87,624,2,30,1,1
56537,445,0,0,drop,70,70,0,1,0,1,0
31404,59961,0,0,deny,100,100,0,1,0,1,0
55920,25174,0,0,deny,146,146,0,1,0,1,0
54264,445,0,0,drop,66,66,0,1,0,1,0
63929,48477,10688,48477,allow,66,66,0,2,7,2,0
53692,53,53692,53,allow,262,82,180,2,29,1,1
49914,443,44270,443,allow,5895,728,5167,16,27,8,8
23528,44847,0,0,deny,62,62,0,1,0,1,0
37981,80,45214,80,allow,1572,755,817,11,15,6,5
35190,80,55473,80,allow,130,70,60,2,14,1,1
46404,53,18296,53,allow,240,86,154,2,30,1,1
53806,37267,15309,37267,allow,70,70,0,2,8,2,0
40216,50265,0,0,deny,62,62,0,1,0,1,0
54839,445,0,0,drop,70,70,0,1,0,1,0
53771,64351,44787,64351,allow,70,70,0,2,8,2,0
40992,443,49820,443,allow,8705,3570,5135,35,100,20,15
54903,445,0,0,drop,66,66,0,1,0,1,0
46176,53,12412,53,allow,168,78,90,2,30,1,1
50078,53,19314,53,allow,185,102,83,2,29,1,1
55743,445,0,0,drop,70,70,0,1,0,1,0
49041,443,30685,443,allow,5144,847,4297,16,132,9,7
61702,445,0,0,drop,66,66,0,1,0,1,0
63023,443,14505,443,allow,382,164,218,2,30,1,1
52107,11191,13712,11191,allow,70,70,0,2,7,2,0
49177,54532,0,0,deny,60,60,0,1,0,1,0
51651,80,41220,80,allow,8100,4781,3319,23,166,12,11
59898,443,21573,443,allow,5429,2835,2594,19,140,9,10
2919,37965,0,0,deny,62,62,0,1,0,1,0
64283,37965,0,0,deny,74,74,0,1,0,1,0
1059,44847,0,0,deny,62,62,0,1,0,1,0
53960,61038,13704,61038,allow,552,306,246,9,14,5,4
57298,443,20012,443,allow,8313,2850,5463,42,15,24,18
65077,445,0,0,drop,70,70,0,1,0,1,0
55476,445,0,0,drop,66,66,0,1,0,1,0
37567,443,17651,443,allow,499,425,74,4,0,3,1
49941,53,13341,53,allow,193,102,91,2,30,1,1
62869,445,0,0,drop,66,66,0,1,0,1,0
57152,53,57152,53,allow,241,98,143,2,30,1,1
57283,64147,0,0,deny,66,66,0,1,0,1,0
56728,443,61064,443,allow,5367,725,4642,15,15,8,7
1138,57470,0,0,deny,146,146,0,1,0,1,0
50438,53,15254,53,allow,296,101,195,4,31,2,2
64979,53,62369,53,allow,754,94,660,2,30,1,1
59060,50584,0,0,deny,66,66,0,1,0,1,0
65344,53,52002,53,allow,190,90,100,3,60,2,1
50494,443,62791,443,allow,5331564,43954,5287610,4171,80,672,3499
28156,50584,0,0,deny,62,62,0,1,0,1,0
56086,53,3627,53,allow,172,94,78,2,30,1,1
50973,445,0,0,drop,70,70,0,1,0,1,0
45405,161,0,0,allow,5858,2302,3556,22,30,11,11
55600,22,0,0,deny,60,60,0,1,0,1,0
52150,445,0,0,drop,70,70,0,1,0,1,0
51863,445,0,0,drop,70,70,0,1,0,1,0
50345,80,27840,80,allow,736,670,66,6,15,5,1
64153,53,31839,53,allow,213,94,119,2,30,1,1
49308,22114,0,0,deny,62,62,0,1,0,1,0
55223,1053,57960,1053,allow,1210,950,260,2,30,1,1
49386,53,12060,53,allow,332,102,230,2,30,1,1
55773,53,49268,53,allow,97,97,0,1,60,1,0
57208,53,63369,53,allow,182,93,89,2,31,1,1
56627,53,14624,53,allow,193,102,91,2,30,1,1
60354,445,0,0,drop,70,70,0,1,0,1,0
48304,443,22064,443,allow,6606,2153,4453,22,95,13,9
24144,57470,0,0,deny,62,62,0,1,0,1,0
49934,53,18444,53,allow,478,107,371,4,39,2,2
58120,25174,0,0,deny,66,66,0,1,0,1,0
43563,443,50861,443,allow,466,392,74,4,0,3,1
56354,53,25392,53,allow,753,93,660,2,30,1,1
50910,445,0,0,drop,70,70,0,1,0,1,0
59147,445,0,0,drop,66,66,0,1,0,1,0
56523,53,49008,53,allow,184,102,82,2,30,1,1
59771,443,63690,443,allow,7672,1164,6508,24,30,12,12
50143,35253,0,0,deny,62,62,0,1,0,1,0
2083,25174,0,0,deny,62,62,0,1,0,1,0
50584,8622,56694,8622,allow,166,166,0,1,1200,1,0
63924,445,0,0,drop,70,70,0,1,0,1,0
50993,445,0,0,drop,66,66,0,1,0,1,0
64245,445,0,0,drop,70,70,0,1,0,1,0
443,54507,0,0,deny,82,82,0,1,0,1,0
10151,54168,22661,54168,allow,479,150,329,2,1200,1,1
60740,443,50087,443,allow,12605,5558,7047,42,101,18,24
9140,80,58869,80,allow,49165,1785,47380,56,36,21,35
54819,3389,54819,3389,allow,3327,1438,1889,15,17,8,7
64724,53,45753,53,allow,336,110,226,2,30,1,1
54324,7000,54324,7000,allow,4007,1690,2317,15,0,8,7
50387,443,41513,443,allow,8507,1945,6562,21,33,10,11
24288,23,0,0,deny,60,60,0,1,0,1,0
7041,37965,0,0,deny,62,62,0,1,0,1,0
47822,80,47822,80,allow,1435,1293,142,5,15,3,2
63239,445,0,0,drop,70,70,0,1,0,1,0
34758,5228,2453,5228,allow,10206,2218,7988,36,4265,18,18
58638,5900,0,0,deny,62,62,0,1,0,1,0
55180,53,4513,53,allow,209,110,99,2,30,1,1
34809,57470,0,0,deny,66,66,0,1,0,1,0
53140,80,7687,80,allow,2560,2083,477,13,15,7,6
65306,53,12072,53,allow,244,94,150,2,30,1,1
37567,443,42814,443,allow,214,140,74,4,15,3,1
62781,445,0,0,drop,66,66,0,1,0,1,0
37554,443,12881,443,allow,13220,4632,8588,32,37,19,13
25067,22114,0,0,deny,146,146,0,1,0,1,0
45941,23386,0,0,deny,60,60,0,1,0,1,0
2238,22114,0,0,deny,62,62,0,1,0,1,0
37395,443,29125,443,allow,16590,1630,14960,33,199,15,18
41365,443,33138,443,allow,27475,5634,21841,76,145,35,41
33825,443,12586,443,allow,15400,12233,3167,75,995,38,37
64366,53,57312,53,allow,234,94,140,2,30,1,1
63433,57866,0,0,deny,66,66,0,1,0,1,0
57471,62413,0,0,deny,66,66,0,1,0,1,0
54678,443,37690,443,allow,84066,79714,4352,98,125,66,32
60936,445,0,0,drop,70,70,0,1,0,1,0
54695,445,0,0,drop,70,70,0,1,0,1,0
52660,443,21035,443,allow,5042,2002,3040,14,119,7,7
51839,80,51839,80,allow,951054,20747,930307,902,26,276,626
33893,80,46490,80,allow,1376,788,588,10,23,6,4
56399,445,0,0,drop,70,70,0,1,0,1,0
49698,53,38054,53,allow,184,102,82,2,30,1,1
50534,53,37578,53,allow,168,86,82,2,31,1,1
49457,445,0,0,drop,66,66,0,1,0,1,0
12951,50584,0,0,deny,66,66,0,1,0,1,0
55619,42873,30146,42873,allow,422,140,282,6,16,3,3
64617,445,0,0,drop,70,70,0,1,0,1,0
61667,80,57155,80,allow,21567,1666,19901,35,46,18,17
63584,445,0,0,drop,70,70,0,1,0,1,0
56065,445,0,0,drop,66,66,0,1,0,1,0
55058,53,41146,53,allow,216,110,106,2,31,1,1
55012,25174,0,0,deny,66,66,0,1,0,1,0
57470,8999,31471,8999,allow,1577,594,983,20,1614,10,10
58861,26467,0,0,deny,66,66,0,1,0,1,0
32909,443,28727,443,allow,160821,7879,152942,201,141,88,113
19156,3846,0,0,deny,145,145,0,1,0,1,0
27005,27018,58513,27018,allow,888,126,762,2,30,1,1
55323,53,14352,53,allow,172,88,84,2,31,1,1
56512,53,8579,53,allow,166,86,80,2,29,1,1
15503,27645,52952,27645,allow,480,149,331,2,1200,1,1
57602,443,23488,443,allow,2614,1689,925,18,20,10,8
46424,443,29456,443,allow,1340,760,580,14,39,8,6
50367,53,23115,53,allow,198,102,96,2,30,1,1
17860,53,17860,53,allow,216,90,126,2,30,1,1
2717,31573,0,0,deny,62,62,0,1,0,1,0
32729,3389,32729,3389,allow,4021,1916,2105,20,18,12,8
55760,443,60909,443,allow,12723734,404530,12319204,13539,134,4494,9045
55555,445,0,0,drop,70,70,0,1,0,1,0
58638,5900,0,0,deny,62,62,0,1,0,1,0
59740,53,42403,53,allow,304,86,218,2,30,1,1
50040,443,40234,443,allow,1097,654,443,12,86,7,5
63486,445,0,0,drop,70,70,0,1,0,1,0
58638,5900,0,0,deny,62,62,0,1,0,1,0
64685,53,52958,53,allow,186,95,91,2,30,1,1
50584,51748,57588,51748,allow,1356,300,1056,6,1200,3,3
5588,5588,0,0,allow,3354,1792,1562,46,194,23,23
57293,445,0,0,drop,70,70,0,1,0,1,0
50627,443,16215,443,allow,8256,1674,6582,31,75,15,16
68,67,0,0,deny,346,346,0,1,0,1,0
27005,27015,35469,27015,allow,886,126,760,2,30,1,1
49405,53,14474,53,allow,94,94,0,1,30,1,0
64820,53,13245,53,allow,190,97,93,2,31,1,1
42951,22114,0,0,deny,66,66,0,1,0,1,0
17344,62413,0,0,deny,62,62,0,1,0,1,0
52044,5824,26075,5824,allow,70,70,0,1,5,1,0
10164,80,10164,80,allow,7351,803,6548,16,24,7,9
59086,53,59086,53,allow,235,90,145,2,32,1,1
52740,443,65500,443,allow,168753,7954,160799,212,26,95,117
56917,53,8537,53,allow,424,104,320,4,30,2,2
56068,53,60568,53,allow,168,94,74,2,30,1,1
59112,443,3834,443,allow,7174,1831,5343,31,110,17,14
52858,445,0,0,drop,70,70,0,1,0,1,0
51880,8000,3169,8000,allow,172,94,78,2,29,1,1
7686,25174,0,0,deny,146,146,0,1,0,1,0
52625,25174,0,0,deny,62,62,0,1,0,1,0
64043,445,0,0,drop,70,70,0,1,0,1,0
50226,80,43900,80,allow,9659,1454,8205,28,278,13,15
63925,18912,65425,18912,allow,66,66,0,2,8,2,0
64493,53,34209,53,allow,280,97,183,4,59,2,2
27005,27019,28419,27019,allow,880,126,754,2,30,1,1
58638,5900,0,0,deny,62,62,0,1,0,1,0
49845,443,22803,443,allow,10396,4585,5811,38,54,21,17
30960,45756,31120,45756,allow,396,396,0,7,3616,7,0
58667,445,0,0,drop,70,70,0,1,0,1,0
64024,57470,0,0,deny,66,66,0,1,0,1,0
27869,51221,0,0,deny,66,66,0,1,0,1,0
55600,53,36294,53,allow,184,94,90,2,30,1,1
49577,57470,0,0,deny,66,66,0,1,0,1,0
16660,55783,0,0,deny,62,62,0,1,0,1,0
55047,53,41022,53,allow,308,94,214,2,29,1,1
50584,1191,3170,1191,allow,161,161,0,2,1200,2,0
55690,445,0,0,drop,70,70,0,1,0,1,0
27005,27015,45197,27015,allow,881,126,755,2,30,1,1
59290,445,0,0,drop,66,66,0,1,0,1,0
58745,30188,0,0,deny,66,66,0,1,0,1,0
59816,443,30172,443,allow,622,310,312,11,29,6,5
22587,30188,0,0,deny,66,66,0,1,0,1,0
52626,44847,0,0,deny,66,66,0,1,0,1,0
62666,445,0,0,drop,66,66,0,1,0,1,0
48786,443,62894,443,allow,7130,1890,5240,25,33,12,13
51594,445,0,0,drop,70,70,0,1,0,1,0
57569,445,0,0,drop,70,70,0,1,0,1,0
55800,53,32257,53,allow,177,94,83,2,30,1,1
58760,443,37477,443,allow,5927,794,5133,17,25,8,9
51166,53,27662,53,allow,168,78,90,2,30,1,1
39771,80,39771,80,allow,17982,4308,13674,30,20,15,15
52819,15503,0,0,deny,66,66,0,1,0,1,0
49869,445,0,0,drop,70,70,0,1,0,1,0
62872,50584,0,0,deny,66,66,0,1,0,1,0
64979,53,10691,53,allow,194,102,92,2,30,1,1
52007,80,41883,80,allow,83736,4405,79331,114,19,48,66
443,9863,0,0,deny,60,60,0,1,0,1,0
58131,42416,0,0,deny,146,146,0,1,0,1,0
56959,445,0,0,drop,70,70,0,1,0,1,0
41321,443,41856,443,allow,9168,1596,7572,22,186,11,11
54659,443,56106,443,allow,1773,1038,735,17,278,9,8
57379,443,26122,443,allow,7211,823,6388,16,15,10,6
24285,26467,0,0,deny,62,62,0,1,0,1,0
59925,80,15613,80,allow,2287,1534,753,11,16,6,5
58638,5900,0,0,deny,62,62,0,1,0,1,0
10886,51505,0,0,deny,62,62,0,1,0,1,0
51031,445,0,0,drop,70,70,0,1,0,1,0
65406,53,43109,53,allow,273,102,171,2,30,1,1
57185,53,50357,53,allow,784,94,690,2,30,1,1
54326,7000,54326,7000,allow,2958,1567,1391,15,15,8,7
64489,445,0,0,drop,70,70,0,1,0,1,0
53211,22114,0,0,deny,66,66,0,1,0,1,0
56564,9571,0,0,deny,78,78,0,1,0,1,0
7275,9524,0,0,deny,66,66,0,1,0,1,0
9144,80,51086,80,allow,378,192,186,7,30,4,3
52013,35185,52958,35185,allow,70,70,0,2,9,2,0
42749,53,42749,53,allow,847,110,737,2,30,1,1
64819,445,0,0,drop,70,70,0,1,0,1,0
63591,443,24703,443,allow,11746,3874,7872,44,141,22,22
55159,53,29350,53,allow,200,102,98,2,30,1,1
50254,44847,0,0,deny,62,62,0,1,0,1,0
49556,443,19377,443,allow,198375,6279,192096,205,153,69,136
49907,53,32516,53,allow,199,102,97,2,30,1,1
64095,443,64095,443,allow,17046,2620,14426,42,159,19,23
53106,445,0,0,drop,70,70,0,1,0,1,0
4041,50584,0,0,deny,62,62,0,1,0,1,0
49700,80,32872,80,allow,56411,2447,53964,58,130,19,39
63826,80,41744,80,allow,314,192,122,6,15,4,2
56474,18375,0,0,deny,62,62,0,1,0,1,0
60055,445,0,0,drop,70,70,0,1,0,1,0
56131,37807,0,0,deny,66,66,0,1,0,1,0
64954,445,0,0,drop,66,66,0,1,0,1,0
64424,445,0,0,drop,66,66,0,1,0,1,0
53398,445,0,0,drop,70,70,0,1,0,1,0
55310,53,54071,53,allow,180,94,86,2,30,1,1
53546,46824,0,0,deny,66,66,0,1,0,1,0
26698,57470,0,0,deny,62,62,0,1,0,1,0
50574,80,28738,80,allow,318,192,126,6,25,4,2
56938,53,8399,53,allow,199,102,97,2,29,1,1
43788,80,23555,80,allow,2597,699,1898,11,181,6,5
55024,445,0,0,drop,70,70,0,1,0,1,0
52187,38153,15114,38153,allow,70,70,0,2,9,2,0
20864,51221,0,0,deny,62,62,0,1,0,1,0
28580,64147,0,0,deny,62,62,0,1,0,1,0
50066,443,28197,443,allow,7144,2505,4639,14,120,7,7
64942,53,4876,53,allow,284,102,182,4,37,2,2
41783,443,41782,443,allow,23344,2097,21247,39,15,18,21
63467,445,0,0,drop,66,66,0,1,0,1,0
50765,22114,0,0,deny,62,62,0,1,0,1,0
50626,43890,0,0,deny,62,62,0,1,0,1,0
50453,80,50453,80,allow,450,246,204,8,30,5,3
48839,37807,0,0,deny,62,62,0,1,0,1,0
55187,53,45900,53,allow,172,94,78,2,29,1,1
35494,22114,0,0,deny,66,66,0,1,0,1,0
49418,27015,12745,27015,allow,227,78,149,2,30,1,1
50373,443,34130,443,allow,5422,707,4715,16,25,8,8
56336,53,36932,53,allow,198,93,105,2,30,1,1
51634,80,59507,80,allow,378,192,186,7,39,4,3
56795,443,62237,443,allow,8021,2001,6020,20,15,11,9
58562,445,0,0,drop,70,70,0,1,0,1,0
50180,445,0,0,drop,70,70,0,1,0,1,0
50899,80,62536,80,allow,13974043,173337,13800706,11715,134,2429,9286
51977,80,44699,80,allow,4305,699,3606,13,46,7,6
6247,51221,0,0,deny,78,78,0,1,0,1,0
61321,445,0,0,drop,66,66,0,1,0,1,0
51732,54299,38142,54299,allow,70,70,0,1,5,1,0
56601,53,16656,53,allow,239,94,145,2,31,1,1
50293,445,0,0,drop,70,70,0,1,0,1,0
55699,53,3858,53,allow,271,103,168,4,59,2,2
443,62732,0,0,deny,332,332,0,1,0,1,0
49790,80,49818,80,allow,1769,1271,498,10,126,6,4
55782,53,37884,53,allow,728,96,632,2,30,1,1
56876,30188,0,0,deny,66,66,0,1,0,1,0
12644,11392,0,0,deny,62,62,0,1,0,1,0
52187,38153,27552,38153,allow,70,70,0,1,4,1,0
58039,80,32642,80,allow,318,192,126,6,21,4,2
3064,44847,0,0,deny,62,62,0,1,0,1,0
0,0,0,0,allow,320,320,0,5,0,5,0
62740,44847,0,0,deny,146,146,0,1,0,1,0
52472,7302,0,0,deny,66,66,0,1,0,1,0
49494,445,0,0,drop,66,66,0,1,0,1,0
49418,49000,14471,49000,allow,270,78,192,2,30,1,1
56826,22114,0,0,deny,66,66,0,1,0,1,0
60210,80,21481,80,allow,5141,3706,1435,17,151,10,7
55600,22,0,0,deny,60,60,0,1,0,1,0
50612,445,0,0,drop,70,70,0,1,0,1,0
52221,33166,38901,33166,allow,66,66,0,1,5,1,0
64012,40642,7765,40642,allow,70,70,0,1,5,1,0
55711,26467,0,0,deny,66,66,0,1,0,1,0
55739,445,0,0,drop,66,66,0,1,0,1,0
57579,445,0,0,drop,70,70,0,1,0,1,0
9529,26467,0,0,deny,62,62,0,1,0,1,0
48620,53,31132,53,allow,199,94,105,2,29,1,1
64162,445,0,0,drop,70,70,0,1,0,1,0
63743,46081,59158,46081,allow,66,66,0,2,7,2,0
17344,62413,0,0,deny,66,66,0,1,0,1,0
49699,53,17835,53,allow,266,89,177,4,58,2,2
61113,443,60052,443,allow,23915,14776,9139,66,136,35,31
56759,55201,4487,55201,allow,70,70,0,2,8,2,0
63092,443,8576,443,allow,4771341,155341,4616000,5024,147,1667,3357
57067,53,26997,53,allow,178,94,84,2,30,1,1
58638,5900,0,0,deny,62,62,0,1,0,1,0
49418,26259,63056,26259,allow,254,78,176,2,30,1,1
50237,445,0,0,drop,70,70,0,1,0,1,0
34692,53,2143,53,allow,271,102,169,2,30,1,1
64593,53,46361,53,allow,258,102,156,2,30,1,1
21447,53,55331,53,allow,245648,213726,31922,2763,89,2579,184
64946,53,64946,53,allow,233,90,143,2,33,1,1
1266,57470,0,0,deny,146,146,0,1,0,1,0
41803,443,1948,443,allow,11804,4009,7795,41,150,21,20
9179,443,30869,443,allow,5731,495,5236,14,15,7,7
55596,53,37319,53,allow,188,96,92,2,31,1,1
49845,53,18683,53,allow,168,86,82,2,31,1,1
42951,22114,0,0,deny,62,62,0,1,0,1,0
60942,445,0,0,drop,70,70,0,1,0,1,0
52072,443,62613,443,allow,7737,6531,1206,21,16,12,9
56752,43888,19580,43888,allow,70,70,0,1,5,1,0
60711,53,53816,53,allow,211,78,133,2,30,1,1
6881,6881,10552,6881,allow,238,118,120,2,1200,1,1
51966,443,55026,443,allow,35199,15909,19290,70,152,34,36
51700,80,43241,80,allow,30853,2456,28397,48,78,25,23
5588,5588,0,0,allow,3498,1872,1626,48,195,24,24
62724,443,24098,443,allow,11195,2218,8977,36,80,18,18
53262,443,28483,443,allow,4385,2869,1516,32,19,18,14
55403,53,28747,53,allow,211,102,109,2,30,1,1
49520,445,0,0,drop,66,66,0,1,0,1,0
50528,445,0,0,drop,70,70,0,1,0,1,0
17750,60780,57502,60780,allow,481,150,331,2,1200,1,1
53899,443,57181,443,allow,499,425,74,4,0,3,1
53972,59089,19075,59089,allow,70,70,0,1,4,1,0
54530,445,0,0,drop,70,70,0,1,0,1,0
65403,445,0,0,drop,66,66,0,1,0,1,0
21322,25174,0,0,deny,62,62,0,1,0,1,0
49825,443,10152,443,allow,15401,3011,12390,37,65,21,16
55364,53,26181,53,allow,168,86,82,2,31,1,1
65216,35440,0,0,deny,66,66,0,1,0,1,0
55438,443,39653,443,allow,6686,923,5763,19,15,11,8
44847,30066,30079,30066,allow,150,150,0,1,1200,1,0
35154,42707,0,0,deny,62,62,0,1,0,1,0
64585,53,55669,53,allow,210,110,100,2,30,1,1
64975,445,0,0,deny,66,66,0,1,0,1,0
53479,445,0,0,drop,66,66,0,1,0,1,0
65472,445,0,0,drop,70,70,0,1,0,1,0
47050,443,20550,443,allow,10868,2200,8668,32,44,14,18
55007,443,13149,443,allow,14030,7043,6987,32,123,18,14
55972,53,36064,53,allow,193,102,91,2,30,1,1
42608,1,0,0,deny,62,62,0,1,0,1,0
57296,53,58059,53,allow,200,102,98,2,29,1,1
55937,53,13424,53,allow,177,94,83,2,30,1,1
53903,51339,10537,51339,allow,70,70,0,1,4,1,0
63220,445,0,0,drop,70,70,0,1,0,1,0
56583,445,0,0,drop,66,66,0,1,0,1,0
21133,11342,54289,11342,allow,478,149,329,2,1200,1,1
42810,443,64537,443,allow,9265,2134,7131,24,123,12,12
16262,80,16262,80,allow,14671,951,13720,23,16,10,13
55858,80,7371,80,allow,104399,8436,95963,122,21,49,73
51652,80,52729,80,allow,32942,2548,30394,58,255,28,30
52060,29868,16909,29868,allow,70,70,0,2,8,2,0
55804,445,0,0,drop,70,70,0,1,0,1,0
4431,32480,0,0,deny,66,66,0,1,0,1,0
50394,443,24134,443,allow,60424,4482,55942,101,686,39,62
49446,445,0,0,drop,70,70,0,1,0,1,0
56645,443,5860,443,allow,32966,3481,29485,49,80,21,28
58638,5900,0,0,deny,62,62,0,1,0,1,0
49506,53,52835,53,allow,200,102,98,2,31,1,1
61677,445,0,0,drop,70,70,0,1,0,1,0
53402,443,53402,443,allow,4582,1675,2907,19,29,11,8
64369,445,0,0,drop,70,70,0,1,0,1,0
54322,27015,10656,27015,allow,924,924,0,3,30,3,0
7524,23,0,0,deny,60,60,0,1,0,1,0
55469,445,0,0,drop,66,66,0,1,0,1,0
56725,53,48111,53,allow,180,94,86,2,31,1,1
58297,443,46075,443,allow,7338,2419,4919,19,17,12,7
41472,53,41472,53,allow,218,90,128,2,30,1,1
49182,53,3761,53,allow,199,102,97,2,29,1,1
56723,443,2144,443,allow,7889,1900,5989,20,15,11,9
60158,445,0,0,drop,70,70,0,1,0,1,0
56237,445,0,0,drop,70,70,0,1,0,1,0
36103,443,46915,443,allow,130,70,60,2,15,1,1
35207,22114,0,0,deny,62,62,0,1,0,1,0
53878,55950,58060,55950,allow,70,70,0,2,8,2,0
51778,60565,25061,60565,allow,70,70,0,2,8,2,0
57927,445,0,0,drop,70,70,0,1,0,1,0
32727,23,0,0,deny,60,60,0,1,0,1,0
9265,37965,0,0,deny,62,62,0,1,0,1,0
41269,443,34077,443,allow,234,234,0,4,12,4,0
42252,33303,0,0,deny,60,60,0,1,0,1,0
42119,36237,0,0,deny,66,66,0,1,0,1,0
50477,443,26806,443,allow,55388,4069,51319,94,240,46,48
43584,24748,0,0,deny,156,156,0,1,0,1,0
56860,445,0,0,drop,70,70,0,1,0,1,0
47728,443,8590,443,allow,8404,3653,4751,25,256,14,11
64112,53,32226,53,allow,281,94,187,2,30,1,1
65143,53,8081,53,allow,199,102,97,2,30,1,1
12457,57866,0,0,deny,62,62,0,1,0,1,0
51615,25174,0,0,deny,66,66,0,1,0,1,0
50316,53,18070,53,allow,816,102,714,2,30,1,1
51866,445,0,0,drop,70,70,0,1,0,1,0
24412,53,24412,53,allow,200,90,110,2,30,1,1
1238,51505,0,0,deny,62,62,0,1,0,1,0
26879,37965,0,0,deny,145,145,0,1,0,1,0
61060,53,35678,53,allow,311,94,217,2,30,1,1
51630,80,41968,80,allow,7679,5325,2354,15,29,8,7
20741,64147,0,0,deny,62,62,0,1,0,1,0
57239,53,5025,53,allow,193,102,91,2,30,1,1
55704,53,48604,53,allow,186,95,91,2,31,1,1
41508,53,41508,53,allow,244,98,146,2,32,1,1
53195,443,44058,443,allow,2016,1160,856,17,46,9,8
10669,49756,0,0,deny,60,60,0,1,0,1,0
1280,25174,0,0,deny,62,62,0,1,0,1,0
57266,53,10699,53,allow,753,96,657,2,31,1,1
4780,443,25705,443,allow,1191,692,499,12,40,7,5
9021,53,9021,53,allow,216,90,126,2,30,1,1
50525,445,0,0,drop,66,66,0,1,0,1,0
51268,47662,19145,47662,allow,70,70,0,1,5,1,0
54031,443,8430,443,allow,350,210,140,6,25,4,2
62952,443,20995,443,allow,1304,612,692,18,120,9,9
64615,53,39093,53,allow,190,97,93,2,31,1,1
3478,61463,0,0,deny,935,935,0,1,0,1,0
9435,443,2463,443,allow,5693,499,5194,14,15,7,7
37595,443,31654,443,allow,34423,3999,30424,52,46,24,28
57470,1337,6563,1337,allow,330,330,0,6,1200,6,0
49523,53,19380,53,allow,314,93,221,4,43,2,2
56689,443,16946,443,allow,7890,1901,5989,20,15,11,9
7226,50584,0,0,deny,62,62,0,1,0,1,0
65327,53,49765,53,allow,822,102,720,2,29,1,1
65483,443,48950,443,allow,92479,4869,87610,109,16,44,65
65431,53,63045,53,allow,210,102,108,2,30,1,1
64592,53,28124,53,allow,197,94,103,2,30,1,1
59395,445,0,0,drop,70,70,0,1,0,1,0
62014,35440,0,0,deny,66,66,0,1,0,1,0
51117,60038,0,0,allow,66,66,0,1,90,1,0
65362,80,32536,80,allow,1347,771,576,11,86,7,4
13285,29892,0,0,deny,145,145,0,1,0,1,0
39735,443,13542,443,allow,280,140,140,5,130,3,2
54452,443,13624,443,allow,4227,1086,3141,15,28,8,7
55564,80,32717,80,allow,944,529,415,11,315,6,5
52931,80,27397,80,allow,78,78,0,1,4,1,0
63203,445,0,0,drop,66,66,0,1,0,1,0
56223,53,58545,53,allow,185,102,83,2,31,1,1
33793,80,7506,80,allow,1286,782,504,12,361,7,5
0,0,0,0,allow,274,274,0,2,0,2,0
52731,445,0,0,drop,70,70,0,1,0,1,0
52157,23002,50044,23002,allow,70,70,0,1,5,1,0
37343,21247,0,0,deny,62,62,0,1,0,1,0
2487,53,2487,53,allow,235,90,145,2,33,1,1
57528,445,0,0,drop,66,66,0,1,0,1,0
60474,53,36065,53,allow,195,94,101,2,30,1,1
27005,27111,30399,27111,allow,893,126,767,2,30,1,1
45511,443,41466,443,allow,130,70,60,2,15,1,1
64997,51221,0,0,deny,66,66,0,1,0,1,0
62245,445,0,0,drop,70,70,0,1,0,1,0
55145,445,0,0,drop,66,66,0,1,0,1,0
58638,5900,0,0,deny,62,62,0,1,0,1,0
57371,445,0,0,drop,70,70,0,1,0,1,0
44246,5228,57956,5228,allow,19678,4762,14916,98,9851,54,44
57416,53,21354,53,allow,193,102,91,2,30,1,1
64822,445,0,0,drop,70,70,0,1,0,1,0
56791,443,55063,443,allow,8021,2001,6020,20,15,11,9
56185,53,12663,53,allow,183,102,81,2,29,1,1
53748,51413,38549,51413,allow,70,70,0,2,7,2,0
49155,443,35211,443,allow,8941,1776,7165,22,136,12,10
61830,443,61830,443,allow,88574,15708,72866,114,176,52,62
9500,443,23639,443,allow,3614,434,3180,11,15,6,5
54981,53,59429,53,allow,757,102,655,2,29,1,1
53035,443,38723,443,allow,20048,9134,10914,96,92,39,57
13581,51505,0,0,deny,62,62,0,1,0,1,0
45472,8168,0,0,deny,62,62,0,1,0,1,0
49398,53,12765,53,allow,226,86,140,2,31,1,1
53373,445,0,0,drop,70,70,0,1,0,1,0
43368,80,43368,80,allow,232198,9152,223046,290,21,134,156
52930,80,36918,80,allow,76193,2105,74088,75,359,23,52
53532,8569,14217,8569,allow,546,306,240,9,143,5,4
22114,4789,50813,4789,allow,70,70,0,1,30,1,0
7423,22114,0,0,deny,146,146,0,1,0,1,0
61535,445,0,0,drop,66,66,0,1,0,1,0
62337,44847,0,0,deny,66,66,0,1,0,1,0
65375,53,14200,53,allow,196,94,102,2,31,1,1
49654,53,58330,53,allow,184,94,90,2,31,1,1
40260,44610,0,0,deny,145,145,0,1,0,1,0
60883,64147,0,0,deny,70,70,0,1,0,1,0
65045,53,56055,53,allow,197,102,95,2,32,1,1
51413,443,55199,443,allow,695,575,120,4,6,2,2
58843,80,20341,80,allow,1439485,27511,1411974,1308,108,369,939
40180,443,53378,443,allow,1310,649,661,13,184,7,6
12709,51505,0,0,deny,62,62,0,1,0,1,0
59187,445,0,0,drop,70,70,0,1,0,1,0
47111,80,20951,80,allow,162355,7124,155231,207,27,96,111
47595,33437,0,0,allow,106,106,0,1,61,1,0
40799,443,51690,443,allow,21024,14637,6387,46,271,26,20
63677,15503,0,0,deny,66,66,0,1,0,1,0
62614,445,0,0,drop,66,66,0,1,0,1,0
64603,445,0,0,drop,66,66,0,1,0,1,0
58255,50584,0,0,deny,62,62,0,1,0,1,0
49907,445,0,0,drop,70,70,0,1,0,1,0
60480,57470,0,0,deny,62,62,0,1,0,1,0
62981,445,0,0,drop,70,70,0,1,0,1,0
56320,53,39261,53,allow,182,93,89,2,31,1,1
39890,443,4730,443,allow,21106,2445,18661,45,20,24,21
61119,53,61119,53,allow,217,90,127,2,29,1,1
58321,445,0,0,drop,70,70,0,1,0,1,0
53951,8999,2950,8999,allow,70,70,0,2,7,2,0
54976,443,15305,443,allow,10335,2317,8018,24,188,13,11
64723,443,61032,443,allow,7978900,79979,7898921,6464,210,644,5820
58413,443,5177,443,allow,9371,1936,7435,26,29,14,12
65093,53,16648,53,allow,266,118,148,2,29,1,1
14255,2767,0,0,deny,62,62,0,1,0,1,0
57804,443,57804,443,allow,4378,1471,2907,19,26,11,8
50351,80,28696,80,allow,1083,653,430,8,15,5,3
57410,37965,0,0,deny,66,66,0,1,0,1,0
52348,62413,0,0,deny,66,66,0,1,0,1,0
57284,22114,0,0,deny,62,62,0,1,0,1,0
9471,443,58396,443,allow,8533,1544,6989,22,30,11,11
56316,445,0,0,drop,70,70,0,1,0,1,0
58888,15000,44683,15000,allow,138,78,60,2,5,1,1
56321,445,0,0,drop,70,70,0,1,0,1,0
64122,53,44861,53,allow,212,108,104,2,31,1,1
54031,53,23447,53,allow,168,78,90,2,30,1,1
1128,44847,0,0,deny,146,146,0,1,0,1,0
53986,54070,39036,54070,allow,70,70,0,1,5,1,0
27005,27016,20035,27016,allow,903,126,777,2,31,1,1
50041,443,48278,443,allow,7924,1798,6126,26,15,14,12
55068,445,0,0,drop,70,70,0,1,0,1,0
5938,16167,0,0,allow,60,60,0,1,91,1,0
49692,53,65365,53,allow,212,110,102,2,30,1,1
50521,443,9816,443,allow,11880,1972,9908,29,78,15,14
50584,6881,48204,6881,allow,161,161,0,1,1200,1,0
64276,26467,0,0,deny,66,66,0,1,0,1,0
55106,53,55106,53,allow,200,90,110,2,30,1,1
57617,80,57617,80,allow,542818,11392,531426,466,25,106,360
51676,445,0,0,drop,70,70,0,1,0,1,0
52278,445,0,0,drop,70,70,0,1,0,1,0
49308,53,5550,53,allow,195,94,101,2,29,1,1
65160,53,39178,53,allow,198,94,104,2,30,1,1
5222,7493,0,0,deny,66,66,0,1,0,1,0
54306,443,48186,443,allow,6376,1576,4800,24,19,13,11
49721,443,52287,443,allow,4588,843,3745,14,52,7,7
49590,80,22848,80,allow,314,128,186,6,26,3,3
65354,53,6099,53,allow,168,86,82,2,31,1,1
52078,443,12860,443,allow,9757,2051,7706,34,256,15,19
64158,445,0,0,drop,70,70,0,1,0,1,0
55003,53,40085,53,allow,196,102,94,2,30,1,1
49310,53,61139,53,allow,186,95,91,3,33,2,1
33871,443,48273,443,allow,11277,2233,9044,43,215,20,23
65264,53,8238,53,allow,256,88,168,4,35,2,2
49409,443,26346,443,allow,6574,2176,4398,28,124,14,14
50278,53,34897,53,allow,819,102,717,2,30,1,1
52144,49344,0,0,deny,62,62,0,1,0,1,0
65344,53,8855,53,allow,180,94,86,2,35,1,1
56982,53,26329,53,allow,193,94,99,2,30,1,1
80,37649,0,0,deny,60,60,0,1,0,1,0
51106,445,0,0,drop,66,66,0,1,0,1,0
60431,445,0,0,drop,70,70,0,1,0,1,0
50912,443,28892,443,allow,8527,2387,6140,21,31,11,10
56579,53,34186,53,allow,711,87,624,2,30,1,1
55130,53,39778,53,allow,216,110,106,2,29,1,1
44719,80,51210,80,allow,1998,1422,576,10,15,6,4
41283,53,41283,53,allow,247,98,149,2,31,1,1
52968,80,9235,80,allow,4004,1347,2657,29,114,15,14
55258,53,48782,53,allow,177,94,83,2,30,1,1
50443,53,37606,53,allow,788,108,680,2,31,1,1
5223,32965,0,0,deny,119,119,0,1,0,1,0
49403,53,28281,53,allow,228,102,126,2,29,1,1
56452,53,0,0,allow,82,82,0,2,40,2,0
50095,50584,0,0,deny,62,62,0,1,0,1,0
64685,53,55702,53,allow,193,102,91,2,30,1,1
65285,44847,0,0,deny,62,62,0,1,0,1,0
56438,3389,56438,3389,allow,3425,1470,1955,16,17,8,8
61527,51050,0,0,deny,66,66,0,1,0,1,0
49397,53,28669,53,allow,365,94,271,2,30,1,1
49426,57470,0,0,deny,62,62,0,1,0,1,0
53833,26467,0,0,deny,62,62,0,1,0,1,0
63643,445,0,0,drop,66,66,0,1,0,1,0
55767,445,0,0,drop,70,70,0,1,0,1,0
60039,80,53912,80,allow,3431,2292,1139,17,142,10,7
55939,53,41055,53,allow,177,94,83,2,30,1,1
50281,443,10698,443,allow,25811,4278,21533,73,100,38,35
33215,37965,0,0,deny,62,62,0,1,0,1,0
59970,443,18481,443,allow,6720,1166,5554,22,360,11,11
50866,443,31244,443,allow,9517,1897,7620,21,130,11,10
64422,445,0,0,drop,66,66,0,1,0,1,0
60250,443,56947,443,allow,12389,5180,7209,31,149,17,14
43111,443,29874,443,allow,3117,1867,1250,19,15,9,10
65454,53,35372,53,allow,218,86,132,2,31,1,1
62044,445,0,0,drop,66,66,0,1,0,1,0
50584,49001,15411,49001,allow,889,161,728,3,1200,2,1
25091,64147,0,0,deny,66,66,0,1,0,1,0
32675,53,58212,53,allow,218,78,140,2,30,1,1
51164,445,0,0,drop,70,70,0,1,0,1,0
43260,41615,0,0,deny,145,145,0,1,0,1,0
56961,53,64914,53,allow,757,102,655,2,30,1,1
50743,445,0,0,drop,70,70,0,1,0,1,0
65291,53,60855,53,allow,335,97,238,4,31,2,2
34470,57470,0,0,deny,66,66,0,1,0,1,0
55423,445,0,0,drop,70,70,0,1,0,1,0
48301,25174,0,0,deny,66,66,0,1,0,1,0
37643,443,56932,443,allow,10517,2926,7591,29,20,16,13
56532,443,14584,443,allow,198167,11702,186465,220,105,84,136
59068,49813,0,0,deny,70,70,0,1,0,1,0
52757,80,11666,80,allow,2426,1594,832,17,151,9,8
59779,443,64471,443,allow,70,70,0,1,5,1,0
56760,443,12477,443,allow,8006,1986,6020,20,15,11,9
38581,22114,0,0,deny,62,62,0,1,0,1,0
51863,22038,12301,22038,allow,70,70,0,1,5,1,0
50682,445,0,0,drop,70,70,0,1,0,1,0
50597,80,50597,80,allow,16296,9143,7153,48,27,26,22
50331,80,36568,80,allow,1677,862,815,10,15,5,5
49485,56972,0,0,deny,66,66,0,1,0,1,0
64950,53,1692,53,allow,183,94,89,2,30,1,1
27005,27015,49083,27015,allow,872,126,746,2,30,1,1
55551,53,53923,53,allow,180,94,86,2,30,1,1
9102,29635,0,0,deny,148,148,0,1,0,1,0
55082,445,0,0,drop,70,70,0,1,0,1,0
58682,443,48693,443,allow,5061,876,4185,16,70,8,8
37437,443,24632,443,allow,4809,818,3991,15,15,8,7
56072,53,61103,53,allow,199,102,97,2,30,1,1
64138,445,0,0,deny,70,70,0,1,0,1,0
60427,80,8033,80,allow,186,64,122,4,28,2,2
55772,445,0,0,drop,70,70,0,1,0,1,0
50878,445,0,0,drop,70,70,0,1,0,1,0
65424,445,0,0,drop,70,70,0,1,0,1,0
36692,443,41344,443,allow,996,526,470,15,30,8,7
25565,43088,0,0,deny,60,60,0,1,0,1,0
52459,33890,0,0,deny,60,60,0,1,0,1,0
55958,53,30538,53,allow,275,86,189,2,29,1,1
50591,22114,0,0,deny,146,146,0,1,0,1,0
30179,57470,0,0,deny,60,60,0,1,0,1,0
56775,53,62594,53,allow,200,94,106,2,29,1,1
51689,53,28477,53,allow,198,86,112,2,29,1,1
64294,64147,0,0,deny,62,62,0,1,0,1,0
59210,50584,0,0,deny,62,62,0,1,0,1,0
59770,443,53384,443,allow,9630,1304,8326,28,30,14,14
49806,53,49806,53,allow,229,89,140,2,31,1,1
61502,443,14539,443,allow,580643,7944,572699,475,41,86,389
50424,55777,0,0,deny,62,62,0,1,0,1,0
51143,445,0,0,drop,70,70,0,1,0,1,0
52957,53,50377,53,allow,168,78,90,2,29,1,1
64709,445,0,0,drop,70,70,0,1,0,1,0
58131,1,0,0,deny,146,146,0,1,0,1,0
35991,443,8225,443,allow,2509208,64544,2444664,2429,304,700,1729
46989,80,46989,80,allow,82082,3212,78870,90,155,27,63
60136,443,22877,443,allow,3647,1221,2426,13,135,6,7
62192,445,0,0,drop,70,70,0,1,0,1,0
55252,443,43197,443,allow,16179,1763,14416,38,46,17,21
54990,53,17689,53,allow,168,86,82,2,29,1,1
56519,53,20744,53,allow,167,86,81,2,29,1,1
59789,443,31655,443,allow,5520,1212,4308,18,28,9,9
56615,443,28312,443,allow,4425,2899,1526,24,34,14,10
43104,26467,0,0,deny,62,62,0,1,0,1,0
55576,445,0,0,drop,66,66,0,1,0,1,0
43271,50584,0,0,deny,62,62,0,1,0,1,0
37694,80,28033,80,allow,1190,591,599,8,15,5,3
25961,55783,0,0,deny,66,66,0,1,0,1,0
45316,80,11125,80,allow,3044854,64416,2980438,2968,19,997,1971
16387,20045,0,0,deny,60,60,0,1,0,1,0
59750,443,51830,443,allow,2633,1179,1454,20,74,8,12
64904,53,43718,53,allow,199,102,97,2,30,1,1
56328,445,0,0,drop,70,70,0,1,0,1,0
64789,53,49397,53,allow,199,102,97,2,30,1,1
57470,59216,60669,59216,allow,594,594,0,10,1200,10,0
59696,57470,0,0,deny,62,62,0,1,0,1,0
65074,53,29931,53,allow,284,118,166,2,30,1,1
26900,27017,64848,27017,allow,422,164,258,6,30,3,3
49662,53,31424,53,allow,268,93,175,4,58,2,2
58638,5900,0,0,deny,62,62,0,1,0,1,0
37833,53,37833,53,allow,222,90,132,2,30,1,1
49966,445,0,0,drop,70,70,0,1,0,1,0
57322,53,27268,53,allow,192,98,94,2,31,1,1
53278,443,20618,443,allow,12634,1635,10999,26,322,11,15
43014,53,60826,53,allow,198,93,105,2,30,1,1
62535,445,0,0,drop,70,70,0,1,0,1,0
58649,445,0,0,drop,70,70,0,1,0,1,0
10416,64147,0,0,deny,62,62,0,1,0,1,0
50563,37965,0,0,deny,66,66,0,1,0,1,0
14489,25174,0,0,deny,62,62,0,1,0,1,0
49743,445,0,0,drop,70,70,0,1,0,1,0
36306,80,36306,80,allow,1917,1468,449,10,20,6,4
49212,38306,32120,38306,allow,70,70,0,2,8,2,0
57168,445,0,0,drop,70,70,0,1,0,1,0
55056,53,24229,53,allow,177,94,83,2,30,1,1
50680,445,0,0,drop,66,66,0,1,0,1,0
54970,443,62898,443,allow,251620,16028,235592,353,371,159,194
59055,11392,0,0,deny,66,66,0,1,0,1,0
52834,445,0,0,drop,70,70,0,1,0,1,0
63047,445,0,0,drop,70,70,0,1,0,1,0
57610,443,60687,443,allow,4327,674,3653,14,25,8,6
63460,445,0,0,drop,70,70,0,1,0,1,0
51769,51505,0,0,deny,66,66,0,1,0,1,0
49267,53,55947,53,allow,184,94,90,2,30,1,1
50708,22114,0,0,deny,62,62,0,1,0,1,0
55268,445,0,0,drop,70,70,0,1,0,1,0
50253,445,0,0,drop,70,70,0,1,0,1,0
52307,445,0,0,drop,70,70,0,1,0,1,0
59794,443,46382,443,allow,408,78,330,6,25,1,5
56439,80,9837,80,allow,17128,1499,15629,24,25,9,15
60199,443,24633,443,allow,5858,1511,4347,20,21,11,9
50265,15402,25420,15402,allow,1450,747,703,16,1200,9,7
55597,445,0,0,drop,70,70,0,1,0,1,0
59033,445,0,0,drop,70,70,0,1,0,1,0
61372,445,0,0,drop,70,70,0,1,0,1,0
33359,30188,0,0,deny,62,62,0,1,0,1,0
5683,44847,0,0,deny,66,66,0,1,0,1,0
53781,37965,0,0,deny,66,66,0,1,0,1,0
56792,53,2003,53,allow,782,105,677,2,31,1,1
54248,445,0,0,drop,66,66,0,1,0,1,0
52772,80,28043,80,allow,2501,1085,1416,15,108,8,7
55211,445,0,0,drop,66,66,0,1,0,1,0
51122,445,0,0,drop,66,66,0,1,0,1,0
49424,53,32316,53,allow,100,100,0,1,0,1,0
64213,53,34758,53,allow,342,105,237,4,53,2,2
22036,44847,0,0,deny,62,62,0,1,0,1,0
56676,37965,0,0,deny,66,66,0,1,0,1,0
51762,80,41389,80,allow,3945,2315,1630,18,74,11,7
52475,443,47203,443,allow,14713,3210,11503,24,135,9,15
37965,17336,18530,17336,allow,481,150,331,2,1199,1,1
52682,22114,0,0,deny,66,66,0,1,0,1,0
58692,53,28574,53,allow,199,94,105,2,30,1,1
51859,35365,47948,35365,allow,70,70,0,2,7,2,0
57453,445,0,0,drop,70,70,0,1,0,1,0
51803,33973,12809,33973,allow,70,70,0,2,8,2,0
14309,56205,0,0,deny,62,62,0,1,0,1,0
58656,445,0,0,drop,70,70,0,1,0,1,0
63945,445,0,0,drop,70,70,0,1,0,1,0
59694,50584,0,0,deny,66,66,0,1,0,1,0
52068,39864,59001,39864,allow,70,70,0,2,8,2,0
24375,12809,0,0,deny,60,60,0,1,0,1,0
58784,445,0,0,drop,66,66,0,1,0,1,0
62846,445,0,0,drop,70,70,0,1,0,1,0
12965,37965,0,0,deny,66,66,0,1,0,1,0
49384,53,22527,53,allow,193,102,91,2,29,1,1
62796,37807,0,0,deny,66,66,0,1,0,1,0
23119,41615,0,0,deny,148,148,0,1,0,1,0
64146,53,50563,53,allow,308,99,209,4,39,2,2
60104,445,0,0,drop,66,66,0,1,0,1,0
49514,52255,0,0,deny,162,162,0,1,0,1,0
49708,53,19621,53,allow,212,94,118,2,29,1,1
52987,445,0,0,drop,70,70,0,1,0,1,0
64633,53,20577,53,allow,255,102,153,2,30,1,1
36498,80,36498,80,allow,161054,3432,157622,140,158,24,116
49932,53,43257,53,allow,195,102,93,2,30,1,1
65085,22114,0,0,deny,66,66,0,1,0,1,0
44929,443,17835,443,allow,554,280,274,9,111,5,4
39236,80,55447,80,allow,190,70,120,4,16,2,2
60109,443,54198,443,allow,268,120,148,5,10,3,2
59845,15503,0,0,deny,66,66,0,1,0,1,0
56822,53,57328,53,allow,184,94,90,2,29,1,1
64281,53,42063,53,allow,214,110,104,2,30,1,1
58638,5900,0,0,deny,62,62,0,1,0,1,0
61690,445,0,0,drop,66,66,0,1,0,1,0
55967,445,0,0,drop,70,70,0,1,0,1,0
28025,443,15107,443,allow,5578,1390,4188,19,15,9,10
49380,21247,0,0,deny,66,66,0,1,0,1,0
61720,445,0,0,drop,70,70,0,1,0,1,0
48303,53,44805,53,allow,198,93,105,2,31,1,1
50305,80,32825,80,allow,5500,2829,2671,19,34,10,9
1594,44847,0,0,deny,62,62,0,1,0,1,0
49958,80,11985,80,allow,11173,821,10352,19,15,9,10
49286,445,0,0,drop,66,66,0,1,0,1,0
65176,53,36351,53,allow,193,102,91,2,31,1,1
50511,445,0,0,drop,70,70,0,1,0,1,0
9320,443,10901,443,allow,3599,566,3033,15,15,8,7
30188,17677,54608,17677,allow,11116,4642,6474,64,1457,30,34
35207,22114,0,0,deny,146,146,0,1,0,1,0
58562,53,31864,53,allow,215,102,113,2,30,1,1
46286,21247,0,0,deny,146,146,0,1,0,1,0
58217,445,0,0,drop,70,70,0,1,0,1,0
64632,445,0,0,drop,66,66,0,1,0,1,0
53829,53,12567,53,allow,258,86,172,2,31,1,1
58426,445,0,0,drop,70,70,0,1,0,1,0
51163,445,0,0,drop,70,70,0,1,0,1,0
46658,53,46658,53,allow,216,98,118,2,30,1,1
57330,53,61035,53,allow,177,94,83,2,30,1,1
65435,53,59924,53,allow,196,94,102,2,29,1,1
58638,5900,0,0,deny,62,62,0,1,0,1,0
58004,445,0,0,drop,70,70,0,1,0,1,0
59352,37965,0,0,deny,66,66,0,1,0,1,0
31750,53,31750,53,allow,200,90,110,2,30,1,1
54153,443,43773,443,allow,5008,2097,2911,13,121,6,7
55024,445,0,0,drop,70,70,0,1,0,1,0
38211,123,28193,123,allow,184,94,90,2,29,1,1
64280,445,0,0,drop,70,70,0,1,0,1,0
60713,443,57689,443,allow,6287,1742,4545,17,19,10,7
59023,64097,0,0,deny,66,66,0,1,0,1,0
55344,53,18078,53,allow,208,106,102,2,31,1,1
63221,53436,0,0,deny,62,62,0,1,0,1,0
26629,56079,0,0,deny,62,62,0,1,0,1,0
58751,9571,0,0,deny,62,62,0,1,0,1,0
50575,443,24477,443,allow,5197,3181,2016,50,261,26,24
55040,80,41951,80,allow,486,240,246,9,34,5,4
64993,445,0,0,drop,66,66,0,1,0,1,0
50236,25174,0,0,deny,66,66,0,1,0,1,0
46619,57470,0,0,deny,62,62,0,1,0,1,0
48187,443,22685,443,allow,1515,568,947,14,82,6,8
1972,57470,0,0,deny,78,78,0,1,0,1,0
65236,53,45022,53,allow,177,94,83,2,30,1,1
46286,21247,0,0,deny,62,62,0,1,0,1,0
64586,445,0,0,drop,66,66,0,1,0,1,0
53816,445,0,0,drop,66,66,0,1,0,1,0
53017,445,0,0,drop,70,70,0,1,0,1,0
59178,53,27947,53,allow,260,86,174,2,30,1,1
50820,443,59076,443,allow,6133,1655,4478,12,121,5,7
60554,445,0,0,drop,70,70,0,1,0,1,0
53117,445,0,0,drop,70,70,0,1,0,1,0
6881,31026,35308,31026,allow,509,150,359,2,1199,1,1
59605,443,24489,443,allow,4507,1525,2982,24,148,13,11
63877,53,63877,53,allow,247,98,149,2,32,1,1
58043,80,57225,80,allow,378,192,186,7,20,4,3
61791,445,0,0,drop,70,70,0,1,0,1,0
65102,53,65408,53,allow,183,94,89,2,30,1,1
50584,64368,19845,64368,allow,161,161,0,2,1200,2,0
27005,27016,11653,27016,allow,876,126,750,3,31,2,1
15499,22114,0,0,deny,146,146,0,1,0,1,0
5283,56205,0,0,deny,146,146,0,1,0,1,0
0,0,0,0,deny,98,98,0,1,0,1,0
60474,445,0,0,drop,66,66,0,1,0,1,0
64689,445,0,0,drop,66,66,0,1,0,1,0
65085,445,0,0,drop,66,66,0,1,0,1,0
55818,445,0,0,drop,70,70,0,1,0,1,0
33243,443,33380,443,allow,1067,650,417,10,31,6,4
50318,445,0,0,drop,70,70,0,1,0,1,0
57092,53,3743,53,allow,228,102,126,2,30,1,1
56808,443,31717,443,allow,7981,1961,6020,20,15,11,9
51935,38639,4270,38639,allow,70,70,0,2,8,2,0
46720,53,0,0,allow,82,82,0,1,30,1,0
44258,25,0,0,deny,74,74,0,1,0,1,0
64779,53,46294,53,allow,497,102,395,4,40,2,2
50153,445,0,0,drop,66,66,0,1,0,1,0
63928,53,2140,53,allow,376,126,250,2,30,1,1
53987,16571,20059,16571,allow,70,70,0,1,5,1,0
49289,53,43256,53,allow,177,94,83,2,30,1,1
61739,445,0,0,drop,70,70,0,1,0,1,0
27348,22114,0,0,deny,66,66,0,1,0,1,0
60762,445,0,0,drop,70,70,0,1,0,1,0
56432,80,52279,80,allow,17128,1499,15629,24,25,9,15
59287,445,0,0,drop,70,70,0,1,0,1,0
48144,21247,0,0,deny,66,66,0,1,0,1,0
50402,8080,50402,8080,allow,378,180,198,7,78,4,3
26467,6969,47386,6969,allow,192,192,0,4,1200,4,0
58857,443,13362,443,allow,3439647,103607,3336040,3670,452,1291,2379
64959,53,12342,53,allow,209,110,99,2,30,1,1
49647,443,38723,443,allow,11011,4522,6489,35,43,17,18
57470,32348,51610,32348,allow,527,166,361,2,1199,1,1
0,0,0,0,deny,98,98,0,1,0,1,0
42790,443,55460,443,allow,13859,3232,10627,50,256,21,29
51984,445,0,0,drop,70,70,0,1,0,1,0
53112,29258,11040,29258,allow,70,70,0,2,8,2,0
56661,53,2934,53,allow,288,93,195,4,32,2,2
62806,445,0,0,drop,70,70,0,1,0,1,0
60465,445,0,0,drop,70,70,0,1,0,1,0
60126,35440,0,0,deny,62,62,0,1,0,1,0
55714,53,2036,53,allow,165,86,79,2,30,1,1
53500,443,28730,443,allow,3036,975,2061,14,136,7,7
40603,443,49368,443,allow,9462,6402,3060,32,394,11,21
6881,63963,28408,63963,allow,207,118,89,2,1200,1,1
49953,53,27349,53,allow,214,110,104,2,29,1,1
65343,53,2539,53,allow,184,94,90,2,31,1,1
25297,11530,0,0,deny,145,145,0,1,0,1,0
44855,58414,0,0,deny,62,62,0,1,0,1,0
63834,27037,35809,27037,allow,1130,924,206,5,30,3,2
49234,53,44202,53,allow,167,86,81,2,30,1,1
61983,50432,0,0,deny,66,66,0,1,0,1,0
51946,9407,60623,9407,allow,70,70,0,1,4,1,0
53166,61600,0,0,deny,66,66,0,1,0,1,0
54769,80,54769,80,allow,23168,3380,19788,36,19,18,18
53465,80,64691,80,allow,1360,540,820,20,187,10,10
56632,443,5495,443,allow,7941,1952,5989,20,15,11,9
62235,445,0,0,drop,70,70,0,1,0,1,0
57131,7774,0,0,deny,145,145,0,1,0,1,0
542,46783,0,0,deny,62,62,0,1,0,1,0
57351,53,48672,53,allow,184,94,90,2,29,1,1
56293,53,53658,53,allow,166,86,80,2,30,1,1
42420,443,29433,443,allow,8616,2683,5933,30,459,15,15
51166,443,54384,443,allow,13072,4708,8364,47,130,24,23
52227,64147,0,0,deny,62,62,0,1,0,1,0
49376,53,15412,53,allow,391,134,257,2,30,1,1
1027,64147,0,0,deny,62,62,0,1,0,1,0
24471,32167,0,0,deny,60,60,0,1,0,1,0
30728,53,30728,53,allow,196,88,108,2,30,1,1
55123,53,57840,53,allow,198,102,96,2,31,1,1
55002,80,41422,80,allow,10872190,337459,10534731,12500,208,5532,6968
58638,5900,0,0,deny,62,62,0,1,0,1,0
45912,44847,0,0,deny,62,62,0,1,0,1,0
55418,53,32806,53,allow,168,86,82,2,30,1,1
56701,53,21171,53,allow,211,110,101,2,30,1,1
55193,53,55120,53,allow,200,102,98,2,33,1,1
56703,445,0,0,drop,70,70,0,1,0,1,0
16387,24782,0,0,deny,60,60,0,1,0,1,0
55090,53,59676,53,allow,196,102,94,2,29,1,1
26717,25174,0,0,deny,62,62,0,1,0,1,0
35196,8635,35196,8635,allow,138,78,60,2,5,1,1
34073,37965,0,0,deny,62,62,0,1,0,1,0
55508,64147,0,0,deny,62,62,0,1,0,1,0
35610,37965,0,0,deny,62,62,0,1,0,1,0
59116,443,24457,443,allow,48923,5417,43506,61,122,25,36
9184,80,49214,80,allow,2066,651,1415,11,35,6,5
65414,443,41456,443,allow,2494,1643,851,17,25,9,8
46857,443,55410,443,allow,280,140,140,5,129,3,2
49501,443,27772,443,allow,1882,1108,774,17,135,10,7
54996,53,30248,53,allow,252,102,150,2,29,1,1
55447,53,41152,53,allow,194,102,92,2,30,1,1
30729,22114,0,0,deny,62,62,0,1,0,1,0
50584,55624,58737,55624,allow,1326,300,1026,6,1200,3,3
49713,53,37729,53,allow,177,94,83,2,30,1,1
41953,443,3719,443,allow,4129,2865,1264,17,361,9,8
61953,445,0,0,drop,70,70,0,1,0,1,0
49712,53,62216,53,allow,178,94,84,2,30,1,1
6881,29517,0,0,deny,146,146,0,1,0,1,0
49301,53,20768,53,allow,214,102,112,2,30,1,1
49478,53,32475,53,allow,551,114,437,4,37,2,2
50586,80,48187,80,allow,6718,3126,3592,16,78,8,8
11582,41599,27860,41599,allow,70,70,0,2,8,2,0
55439,53,44673,53,allow,177,94,83,2,30,1,1
50462,80,58102,80,allow,4603,2152,2451,14,22,8,6
37577,443,55436,443,allow,499,425,74,4,0,3,1
56750,53,18998,53,allow,279,118,161,2,30,1,1
41462,2323,0,0,deny,60,60,0,1,0,1,0
63707,28423,64677,28423,allow,564,382,182,9,16,6,3
55452,53,7661,53,allow,184,94,90,2,30,1,1
64627,53,12613,53,allow,184,102,82,2,31,1,1
58962,445,0,0,drop,70,70,0,1,0,1,0
65490,443,45608,443,allow,405489,12010,393479,416,16,146,270
49841,53,34208,53,allow,264,110,154,2,31,1,1
49222,53,61468,53,allow,418,150,268,2,30,1,1
49609,80,50781,80,allow,318,192,126,6,41,4,2
49205,29020,24277,29020,allow,316,136,180,6,7,3,3
56659,443,54837,443,allow,8058,2038,6020,20,15,11,9
35421,30188,0,0,deny,146,146,0,1,0,1,0
51409,443,49977,443,allow,394,70,324,7,31,2,5
62653,445,0,0,drop,66,66,0,1,0,1,0
64678,53,7690,53,allow,758,93,665,2,31,1,1
52061,80,7969,80,allow,366,240,126,7,25,5,2
53940,53,37682,53,allow,70,70,0,1,30,1,0
63282,445,0,0,drop,70,70,0,1,0,1,0
2522,64147,0,0,deny,62,62,0,1,0,1,0
7720,44847,0,0,deny,66,66,0,1,0,1,0
45964,55559,0,0,deny,60,60,0,1,0,1,0
60132,443,39833,443,allow,350,210,140,6,25,4,2
30800,25174,0,0,deny,146,146,0,1,0,1,0
55620,53,62411,53,allow,178,94,84,2,30,1,1
60957,443,56619,443,allow,68539,4175,64364,98,32,46,52
59943,37807,0,0,deny,62,62,0,1,0,1,0
52145,36670,58227,36670,allow,316,136,180,6,6,3,3
50867,443,26907,443,allow,6351,1370,4981,18,131,9,9
19412,53,19412,53,allow,229,98,131,2,30,1,1
49293,53,18352,53,allow,294,88,206,4,57,2,2
49902,445,0,0,deny,70,70,0,1,0,1,0
62812,445,0,0,drop,66,66,0,1,0,1,0
65496,443,16540,443,allow,92799,4939,87860,111,16,45,66
49903,445,0,0,drop,66,66,0,1,0,1,0
56489,53,35362,53,allow,178,94,84,2,29,1,1
56556,53,39317,53,allow,762,97,665,2,30,1,1
51755,24236,52970,24236,allow,136,136,0,3,13,3,0
49705,80,19257,80,allow,2733,591,2142,11,45,6,5
45941,23386,0,0,deny,60,60,0,1,0,1,0
30765,56205,0,0,deny,66,66,0,1,0,1,0
65385,53,41370,53,allow,259,110,149,2,30,1,1
37661,443,23960,443,allow,3226,2225,1001,18,46,11,7
56004,443,20130,443,allow,53826,3670,50156,85,275,41,44
34783,5222,34830,5222,allow,482,210,272,8,15,4,4
48360,443,45618,443,allow,8400,2088,6312,33,20,18,15
50651,445,0,0,drop,70,70,0,1,0,1,0
17777,30188,0,0,deny,62,62,0,1,0,1,0
56253,445,0,0,drop,66,66,0,1,0,1,0
57470,6969,61511,6969,allow,37677,7875,29802,115,3342,58,57
65477,445,0,0,drop,70,70,0,1,0,1,0
57115,53,15026,53,allow,756,95,661,2,30,1,1
49983,53,19113,53,allow,267,110,157,2,30,1,1
64326,53,53148,53,allow,323,107,216,4,38,2,2
55350,53,12521,53,allow,185,102,83,2,29,1,1
51880,18468,1087,18468,allow,70,70,0,2,8,2,0
63492,445,0,0,drop,70,70,0,1,0,1,0
48643,80,57942,80,allow,1912,1464,448,14,16,7,7
63217,445,0,0,drop,70,70,0,1,0,1,0
55664,53,37409,53,allow,195,102,93,2,30,1,1
1024,25174,0,0,deny,62,62,0,1,0,1,0
37965,21859,39298,21859,allow,481,150,331,2,1199,1,1
27922,25174,0,0,deny,62,62,0,1,0,1,0
60351,50584,0,0,deny,62,62,0,1,0,1,0
49216,63752,46385,63752,allow,70,70,0,2,8,2,0
63984,445,0,0,drop,66,66,0,1,0,1,0
59942,22114,0,0,deny,62,62,0,1,0,1,0
46987,443,53868,443,allow,8688,3211,5477,24,343,11,13
51840,80,51840,80,allow,525257,17273,507984,531,26,183,348
49217,53,2129,53,allow,209,110,99,2,31,1,1
50770,443,41782,443,allow,6350,1369,4981,18,151,9,9
51413,48637,0,0,deny,72,72,0,1,0,1,0
57243,443,49244,443,allow,27444,3840,23604,58,161,28,30
57168,53,20859,53,allow,760,96,664,2,30,1,1
57110,445,0,0,drop,70,70,0,1,0,1,0
49531,53,21298,53,allow,740,93,647,2,31,1,1
50488,22114,0,0,deny,66,66,0,1,0,1,0
51509,443,60240,443,allow,1307,688,619,14,37,8,6
60632,445,0,0,drop,70,70,0,1,0,1,0
49304,7010,49304,7010,allow,6247,4138,2109,21,15,13,8
56068,53,21388,53,allow,214,102,112,2,30,1,1
61099,445,0,0,drop,70,70,0,1,0,1,0
60192,35440,0,0,deny,146,146,0,1,0,1,0
60616,445,0,0,drop,66,66,0,1,0,1,0
50439,443,55602,443,allow,73712,18850,54862,135,717,61,74
49894,445,0,0,drop,66,66,0,1,0,1,0
56239,53,9531,53,allow,179,86,93,2,29,1,1
58638,5900,0,0,deny,62,62,0,1,0,1,0
57800,445,0,0,drop,66,66,0,1,0,1,0
49228,53,7287,53,allow,193,102,91,2,30,1,1
64592,53,37714,53,allow,202,103,99,2,31,1,1
58497,39004,0,0,deny,66,66,0,1,0,1,0
49195,8108,53972,8108,allow,70,70,0,1,5,1,0
51430,443,37453,443,allow,7318,1585,5733,24,50,14,10
65107,53,56824,53,allow,266,87,179,4,32,2,2
51401,6881,0,0,deny,62,62,0,1,0,1,0
57750,37965,0,0,deny,62,62,0,1,0,1,0
9327,57470,0,0,deny,62,62,0,1,0,1,0
45304,64147,0,0,deny,72,72,0,1,0,1,0
57301,445,0,0,drop,70,70,0,1,0,1,0
64900,53,45787,53,allow,197,102,95,2,30,1,1
54475,445,0,0,drop,66,66,0,1,0,1,0
55349,53,28852,53,allow,744,89,655,2,30,1,1
53981,29500,46111,29500,allow,320,140,180,6,7,3,3
49805,443,42807,443,allow,2839,1654,1185,15,126,9,6
60433,445,0,0,drop,66,66,0,1,0,1,0
49925,53,18861,53,allow,953,215,738,6,46,3,3
55887,443,44668,443,allow,3954,778,3176,17,121,8,9
65400,36237,0,0,deny,66,66,0,1,0,1,0
50530,80,18434,80,allow,3561,1337,2224,13,20,7,6
58114,445,0,0,drop,66,66,0,1,0,1,0
64490,445,0,0,drop,70,70,0,1,0,1,0
58638,5900,0,0,deny,62,62,0,1,0,1,0
60709,443,60709,443,allow,1092,645,447,10,34,6,4
63067,445,0,0,drop,66,66,0,1,0,1,0
0,0,0,0,allow,156,156,0,2,0,2,0
42298,40008,62209,40008,allow,148,86,62,2,30,1,1
56487,53,61282,53,allow,194,102,92,2,31,1,1
56395,443,48597,443,allow,77506,2940,74566,100,80,38,62
51492,445,0,0,drop,70,70,0,1,0,1,0
54961,53,50012,53,allow,211,102,109,2,29,1,1
45118,39004,0,0,deny,74,74,0,1,0,1,0
51822,445,0,0,drop,70,70,0,1,0,1,0
35339,443,19701,443,allow,6677,1006,5671,19,27,11,8
59191,35440,0,0,deny,66,66,0,1,0,1,0
27005,1306,35061,1306,allow,858,126,732,2,29,1,1
61455,64147,0,0,deny,66,66,0,1,0,1,0
55503,53,13265,53,allow,200,102,98,2,30,1,1
51396,56205,0,0,deny,62,62,0,1,0,1,0
41471,443,22977,443,allow,1973617,48070,1925547,1945,84,606,1339
64488,53,18852,53,allow,291,102,189,2,29,1,1
56806,46903,25071,46903,allow,3060,1569,1491,12,17,7,5
63925,445,0,0,drop,70,70,0,1,0,1,0
54620,445,0,0,deny,70,70,0,1,0,1,0
44169,443,53615,443,allow,12098,5328,6770,25,121,12,13
1028,62609,0,0,deny,148,148,0,1,0,1,0
37614,53,37614,53,allow,209,98,111,2,30,1,1
51411,443,64614,443,allow,7842,1155,6687,19,105,10,9
53822,25174,0,0,deny,66,66,0,1,0,1,0
59696,57470,0,0,deny,62,62,0,1,0,1,0
14199,443,14199,443,allow,416,198,218,7,27,4,3
49672,443,34216,443,allow,10080,2728,7352,28,188,14,14
53883,445,0,0,drop,66,66,0,1,0,1,0
55055,80,30882,80,allow,306,180,126,6,26,4,2
52131,28980,37358,28980,allow,66,66,0,1,5,1,0
61222,445,0,0,drop,70,70,0,1,0,1,0
56335,53,31703,53,allow,260,102,158,2,30,1,1
65451,445,0,0,drop,66,66,0,1,0,1,0
53419,28189,0,0,deny,60,60,0,1,0,1,0
40242,443,42973,443,allow,7407,2516,4891,37,32,19,18
27005,27015,34659,27015,allow,899,126,773,2,30,1,1
19790,35440,0,0,deny,146,146,0,1,0,1,0
57343,53,26142,53,allow,178,91,87,2,31,1,1
7444,57470,0,0,deny,66,66,0,1,0,1,0
56255,53,37256,53,allow,701,88,613,2,31,1,1
54471,36237,0,0,deny,66,66,0,1,0,1,0
56639,48817,0,0,deny,66,66,0,1,0,1,0
65515,53,35838,53,allow,718,94,624,2,30,1,1
64135,53,37160,53,allow,196,102,94,2,30,1,1
56337,53,29643,53,allow,268,89,179,4,45,2,2
25565,2216,0,0,deny,60,60,0,1,0,1,0
35718,20238,0,0,deny,62,62,0,1,0,1,0
49772,53,62355,53,allow,181,94,87,2,29,1,1
64811,445,0,0,drop,70,70,0,1,0,1,0
65128,445,0,0,drop,66,66,0,1,0,1,0
50126,445,0,0,drop,70,70,0,1,0,1,0
3103,50584,0,0,deny,62,62,0,1,0,1,0
53665,445,0,0,drop,70,70,0,1,0,1,0
61989,445,0,0,drop,70,70,0,1,0,1,0
31950,22114,0,0,deny,62,62,0,1,0,1,0
40642,23889,0,0,deny,146,146,0,1,0,1,0
58638,5900,0,0,deny,62,62,0,1,0,1,0
51062,1433,0,0,deny,60,60,0,1,0,1,0
26889,50265,0,0,deny,66,66,0,1,0,1,0
62186,445,0,0,drop,66,66,0,1,0,1,0
60445,20555,38160,20555,allow,70,70,0,1,5,1,0
57655,445,0,0,drop,70,70,0,1,0,1,0
55470,445,0,0,drop,70,70,0,1,0,1,0
56756,53,38135,53,allow,167,86,81,2,30,1,1
64723,445,0,0,drop,70,70,0,1,0,1,0
50039,445,0,0,drop,70,70,0,1,0,1,0
55204,53,55204,53,allow,239,98,141,2,30,1,1
64957,53,47584,53,allow,192,98,94,2,30,1,1
49245,53,34102,53,allow,376,126,250,2,29,1,1
56075,443,56807,443,allow,5640,3241,2399,22,120,11,11
53799,80,41607,80,allow,1056,682,374,10,15,6,4
62042,80,65130,80,allow,10924,548,10376,17,48,6,11
61363,445,0,0,drop,66,66,0,1,0,1,0
54828,443,1359,443,allow,150,150,0,1,5,1,0
59018,445,0,0,drop,70,70,0,1,0,1,0
46728,443,17105,443,allow,7087,746,6341,16,15,9,7
37586,443,60521,443,allow,499,425,74,4,0,3,1
21641,51505,0,0,deny,62,62,0,1,0,1,0
57772,50584,0,0,deny,66,66,0,1,0,1,0
42298,40038,63975,40038,allow,148,86,62,2,30,1,1
60059,445,0,0,drop,70,70,0,1,0,1,0
50522,443,53720,443,allow,460,394,66,4,0,3,1
63495,50584,0,0,deny,66,66,0,1,0,1,0
56928,53,33620,53,allow,172,88,84,2,30,1,1
44037,5223,40215,5223,allow,5096,1030,4066,25,1751,9,16
52406,443,12118,443,allow,11463,850,10613,23,25,7,16
50552,445,0,0,drop,66,66,0,1,0,1,0
60418,39537,32602,39537,allow,70,70,0,2,8,2,0
45079,443,33534,443,allow,7298,2661,4637,21,18,11,10
15605,50265,0,0,deny,62,62,0,1,0,1,0
55994,22114,0,0,deny,66,66,0,1,0,1,0
36357,443,35351,443,allow,14614,1935,12679,36,16,20,16
55830,53,13004,53,allow,177,94,83,2,30,1,1
56356,53,26889,53,allow,277,118,159,2,30,1,1
55554,22114,0,0,deny,62,62,0,1,0,1,0
0,0,0,0,deny,98,98,0,1,0,1,0
54118,6004,0,0,deny,66,66,0,1,0,1,0
58638,5900,0,0,deny,62,62,0,1,0,1,0
58859,445,0,0,drop,70,70,0,1,0,1,0
53717,443,51020,443,allow,499,425,74,4,0,3,1
50510,53,6283,53,allow,734,94,640,2,30,1,1
64887,445,0,0,drop,70,70,0,1,0,1,0
55894,53,40691,53,allow,216,102,114,2,30,1,1
64768,53,30558,53,allow,394,102,292,2,29,1,1
53910,1024,52372,1024,allow,70,70,0,2,8,2,0
54356,443,29580,443,allow,18744,10266,8478,44,35,21,23
50937,445,0,0,drop,70,70,0,1,0,1,0
55396,26467,0,0,deny,62,62,0,1,0,1,0
42318,53,4117,53,allow,164,78,86,2,30,1,1
50178,53,23159,53,allow,758,96,662,2,31,1,1
51655,26467,0,0,deny,62,62,0,1,0,1,0
46512,63836,0,0,deny,148,148,0,1,0,1,0
51441,445,0,0,drop,66,66,0,1,0,1,0
60875,443,9147,443,allow,45373,35377,9996,88,72,48,40
55877,42466,20270,42466,allow,481,150,331,2,1200,1,1
38959,25174,0,0,deny,62,62,0,1,0,1,0
64312,445,0,0,drop,66,66,0,1,0,1,0
49345,80,49345,80,allow,450,246,204,8,142,5,3
23333,53,23333,53,allow,215,80,135,2,33,1,1
59530,445,0,0,drop,66,66,0,1,0,1,0
61968,445,0,0,drop,70,70,0,1,0,1,0
49256,53,11555,53,allow,179,94,85,2,30,1,1
64128,53,50271,53,allow,606,182,424,6,71,3,3
61438,443,9604,443,allow,4933,771,4162,18,28,8,10
58638,5900,0,0,deny,62,62,0,1,0,1,0
55636,80,55636,80,allow,1916,1467,449,10,19,6,4
60116,445,0,0,drop,70,70,0,1,0,1,0
13911,57470,0,0,deny,60,60,0,1,0,1,0
56834,445,0,0,drop,70,70,0,1,0,1,0
60500,443,54155,443,allow,103479,7755,95724,165,19,70,95
27005,37569,49792,37569,allow,892,126,766,2,30,1,1
58638,5900,0,0,deny,62,62,0,1,0,1,0
53835,62413,0,0,deny,62,62,0,1,0,1,0
62152,56205,0,0,deny,66,66,0,1,0,1,0
56067,445,0,0,drop,66,66,0,1,0,1,0
62972,445,0,0,drop,66,66,0,1,0,1,0
55893,45711,0,0,deny,78,78,0,1,0,1,0
64236,445,0,0,drop,66,66,0,1,0,1,0
55886,445,0,0,drop,70,70,0,1,0,1,0
52695,26467,0,0,deny,66,66,0,1,0,1,0
55688,53,8374,53,allow,184,94,90,2,30,1,1
35626,22114,0,0,deny,62,62,0,1,0,1,0
61566,44847,0,0,deny,62,62,0,1,0,1,0
43095,443,16830,443,allow,3067,1817,1250,18,16,8,10
57269,53,43829,53,allow,183,94,89,2,30,1,1
55058,53,43398,53,allow,216,110,106,2,31,1,1
65249,25864,0,0,deny,72,72,0,1,0,1,0
27005,27017,57092,27017,allow,900,126,774,2,30,1,1
57439,445,0,0,drop,66,66,0,1,0,1,0
56628,80,40916,80,allow,1359,435,924,13,30,7,6
55987,53,22591,53,allow,733,85,648,2,0,1,1
52175,1101,39473,1101,allow,70,70,0,2,8,2,0
65178,53,0,0,allow,190,85,105,2,30,1,1
48817,32897,48817,32897,allow,152,152,0,1,1200,1,0
21424,53,21424,53,allow,225,90,135,2,29,1,1
63815,445,0,0,drop,70,70,0,1,0,1,0
60372,80,60372,80,allow,186272,9792,176480,216,21,93,123
54986,53,42487,53,allow,214,110,104,2,30,1,1
50386,80,26554,80,allow,6718,3126,3592,16,77,8,8
64483,445,0,0,drop,66,66,0,1,0,1,0
9327,57470,0,0,deny,62,62,0,1,0,1,0
51003,445,0,0,drop,70,70,0,1,0,1,0
60191,443,1843,443,allow,7292,950,6342,19,125,9,10
59923,53,7241,53,allow,197,78,119,2,30,1,1
50584,49533,38774,49533,allow,161,161,0,1,1200,1,0
50265,43974,25412,43974,allow,132,132,0,3,1200,3,0
27448,5222,60213,5222,allow,8039,1649,6390,41,357,13,28
27450,443,32260,443,allow,10099,1635,8464,31,83,14,17
45673,30188,0,0,deny,62,62,0,1,0,1,0
54797,445,0,0,drop,70,70,0,1,0,1,0
64598,53,46493,53,allow,342,142,200,2,30,1,1
48861,53,40652,53,allow,164,78,86,2,30,1,1
33931,50584,0,0,deny,62,62,0,1,0,1,0
50566,443,4143,443,allow,2064,1287,777,16,139,9,7
12604,3389,12604,3389,reset-both,293,223,70,4,1,3,1
63984,25174,0,0,deny,62,62,0,1,0,1,0
33314,44847,0,0,deny,62,62,0,1,0,1,0
52837,35440,0,0,deny,66,66,0,1,0,1,0
51424,80,51424,80,allow,4995,3443,1552,23,26,13,10
42895,53,15137,53,allow,168,78,90,2,30,1,1
50666,80,35544,80,allow,2937,1241,1696,12,22,7,5
52951,80,38288,80,allow,6266,4430,1836,22,358,13,9
48817,42099,48817,42099,allow,479,152,327,2,1200,1,1
63914,32805,62469,32805,allow,66,66,0,2,8,2,0
55286,53,19401,53,allow,268,87,181,4,35,2,2
55375,445,0,0,drop,70,70,0,1,0,1,0
60011,443,19677,443,allow,8413,3768,4645,25,143,12,13
37002,443,19218,443,allow,6646,2747,3899,20,134,10,10
50122,53,55627,53,allow,811,94,717,2,31,1,1
51820,80,11900,80,allow,366,240,126,7,25,5,2
58123,80,21790,80,allow,3641,1784,1857,19,375,10,9
58955,445,0,0,drop,70,70,0,1,0,1,0
61123,80,61123,80,allow,21678,2120,19558,33,20,16,17
59994,11446,0,0,deny,66,66,0,1,0,1,0
51839,27256,49193,27256,allow,70,70,0,1,5,1,0
56693,1900,0,0,deny,139,139,0,1,0,1,0
56769,53,53195,53,allow,183,94,89,2,30,1,1
43274,443,35686,443,allow,6645,1668,4977,21,31,12,9
55179,80,55179,80,allow,374,240,134,7,15,5,2
58723,443,11514,443,allow,24079,11282,12797,44,17,22,22
65291,53,24701,53,allow,195,102,93,2,30,1,1
56378,53,11573,53,allow,214,102,112,2,30,1,1
21519,443,21519,443,allow,14483,1152,13331,27,19,12,15
34488,443,33891,443,allow,8363,1573,6790,24,49,14,10
49418,30000,55086,30000,allow,280,78,202,2,30,1,1
27005,27015,35363,27015,allow,884,126,758,2,31,1,1
58811,53976,0,0,deny,66,66,0,1,0,1,0
49216,53,15355,53,allow,181,94,87,2,30,1,1
51105,80,8408,80,allow,366,240,126,7,20,5,2
27005,1101,40896,1101,allow,902,126,776,2,30,1,1
65367,53,6408,53,allow,251,94,157,2,30,1,1
45939,5228,13443,5228,allow,7528,1416,6112,29,811,11,18
49759,53,16085,53,allow,216,110,106,2,29,1,1
64040,53,17235,53,allow,226,102,124,2,29,1,1
443,60496,0,0,deny,320,320,0,1,0,1,0
54028,37965,0,0,deny,66,66,0,1,0,1,0
53419,28189,0,0,deny,60,60,0,1,0,1,0
59947,445,0,0,drop,66,66,0,1,0,1,0
51812,15279,41054,15279,allow,70,70,0,1,4,1,0
56322,80,56322,80,allow,27189,4515,22674,34,23,14,20
60575,80,18847,80,allow,9034,1860,7174,17,16,8,9
38690,443,51124,443,allow,1107678,21465,1086213,1058,16,312,746
51221,62348,26234,62348,allow,132,132,0,3,1200,3,0
64105,445,0,0,drop,66,66,0,1,0,1,0
55325,53,2560,53,allow,210,110,100,2,30,1,1
50999,443,32321,443,allow,3051,1801,1250,18,16,8,10
36682,443,16201,443,allow,4590,3104,1486,25,95,14,11
55089,80,46073,80,allow,1558,452,1106,11,15,6,5
59786,25174,0,0,deny,66,66,0,1,0,1,0
56999,25174,0,0,deny,62,62,0,1,0,1,0
55172,445,0,0,drop,70,70,0,1,0,1,0
57073,53,22592,53,allow,197,102,95,2,33,1,1
49948,53,46968,53,allow,177,94,83,2,30,1,1
55724,445,0,0,drop,70,70,0,1,0,1,0
53556,1024,47936,1024,allow,70,70,0,1,4,1,0
55661,49671,9206,49671,allow,70,70,0,2,8,2,0
41664,53,40771,53,allow,376,78,298,2,30,1,1
61150,11392,0,0,deny,66,66,0,1,0,1,0
52775,445,0,0,drop,66,66,0,1,0,1,0
50699,445,0,0,drop,66,66,0,1,0,1,0
60313,445,0,0,drop,70,70,0,1,0,1,0
59400,445,0,0,drop,66,66,0,1,0,1,0
59030,445,0,0,drop,70,70,0,1,0,1,0
54630,53,54630,53,allow,825,99,726,2,30,1,1
58638,5900,0,0,deny,62,62,0,1,0,1,0
26330,26348,0,0,deny,62,62,0,1,0,1,0
9457,443,13669,443,allow,5316,488,4828,14,15,7,7
49367,51505,0,0,deny,66,66,0,1,0,1,0
52666,445,0,0,drop,66,66,0,1,0,1,0
54889,443,50379,443,allow,4600,2214,2386,13,134,7,6
43063,57470,0,0,deny,62,62,0,1,0,1,0
52616,80,52616,80,allow,3366,2547,819,15,49,8,7
9687,57470,0,0,deny,78,78,0,1,0,1,0
61471,445,0,0,drop,70,70,0,1,0,1,0
63272,445,0,0,drop,70,70,0,1,0,1,0
49976,22114,0,0,deny,62,62,0,1,0,1,0
33822,57470,0,0,deny,66,66,0,1,0,1,0
58730,443,58122,443,allow,5110,950,4160,21,48,10,11
50468,443,35607,443,allow,227265,6450,220815,225,124,63,162
30794,37965,0,0,deny,62,62,0,1,0,1,0
64636,53,38894,53,allow,182,102,80,2,30,1,1
35120,26467,0,0,deny,62,62,0,1,0,1,0
36588,5223,46105,5223,allow,4336,1518,2818,23,3005,14,9
56047,443,45831,443,allow,126,60,66,3,4,2,1
58638,5900,0,0,deny,62,62,0,1,0,1,0
60714,50584,0,0,deny,66,66,0,1,0,1,0
36883,80,30047,80,allow,114410,3755,110655,128,38,47,81
27368,22114,0,0,deny,62,62,0,1,0,1,0
59430,50584,0,0,deny,66,66,0,1,0,1,0
52745,57866,0,0,deny,62,62,0,1,0,1,0
50309,53,52592,53,allow,816,102,714,2,29,1,1
19245,64147,0,0,deny,62,62,0,1,0,1,0
58638,5900,0,0,deny,62,62,0,1,0,1,0
64230,445,0,0,drop,70,70,0,1,0,1,0
52951,445,0,0,drop,70,70,0,1,0,1,0
64669,53,24998,53,allow,198,94,104,2,30,1,1
50584,1283,8544,1283,allow,1617,161,1456,4,1199,2,2
22075,53,22075,53,allow,404,259,145,3,33,2,1
60960,445,0,0,drop,70,70,0,1,0,1,0
44385,53,19261,53,allow,212,78,134,2,30,1,1
13406,22114,0,0,deny,62,62,0,1,0,1,0
26420,25174,0,0,deny,66,66,0,1,0,1,0
37564,443,36169,443,allow,499,425,74,4,0,3,1
56852,49677,39171,49677,allow,130,70,60,2,5,1,1
55229,443,47978,443,allow,3602,1519,2083,18,60,10,8
56388,53,30178,53,allow,165,86,79,2,30,1,1
52711,443,58119,443,allow,15118,3979,11139,34,353,17,17
1024,48817,0,0,deny,148,148,0,1,0,1,0
57239,53,14403,53,allow,193,102,91,2,31,1,1
65354,53,35359,53,allow,272,94,178,2,31,1,1
65250,53,37683,53,allow,353,98,255,4,32,2,2
1926,53,62848,53,allow,210,78,132,2,30,1,1
54321,27015,6955,27015,allow,924,924,0,3,30,3,0
58876,443,42159,443,allow,19357,12948,6409,47,18,26,21
64837,53,36950,53,allow,195,102,93,2,30,1,1
40439,443,42690,443,allow,8126,1627,6499,29,165,16,13
58638,5900,0,0,deny,62,62,0,1,0,1,0
57470,6881,64620,6881,allow,577,251,326,4,1200,2,2
59819,443,17243,443,allow,1401,864,537,12,29,6,6
39312,443,51370,443,allow,10148,2203,7945,37,120,19,18
57470,6881,50879,6881,allow,1806,726,1080,24,2426,12,12
49396,53,24683,53,allow,170,87,83,2,30,1,1
55597,7485,9099,7485,allow,70,70,0,2,8,2,0
1024,37450,0,0,deny,62,62,0,1,0,1,0
54413,445,0,0,drop,66,66,0,1,0,1,0
53170,20259,55641,20259,allow,70,70,0,1,5,1,0
56704,53,35730,53,allow,210,94,116,2,30,1,1
53912,26467,0,0,deny,66,66,0,1,0,1,0
64404,53,48455,53,allow,224,94,130,2,30,1,1
36405,443,39201,443,allow,1149,709,440,13,38,8,5
56204,53,64652,53,allow,168,86,82,2,29,1,1
55657,53,52636,53,allow,822,102,720,2,30,1,1
56688,53,20462,53,allow,196,102,94,2,30,1,1
26084,36237,0,0,deny,66,66,0,1,0,1,0
58188,445,0,0,drop,70,70,0,1,0,1,0
56277,445,0,0,drop,66,66,0,1,0,1,0
57129,445,0,0,drop,70,70,0,1,0,1,0
56115,53,55783,53,allow,278,96,182,4,54,2,2
61050,445,0,0,drop,66,66,0,1,0,1,0
4772,37965,0,0,deny,66,66,0,1,0,1,0
51227,445,0,0,drop,70,70,0,1,0,1,0
51963,443,38927,443,allow,14602,6734,7868,46,56,26,20
64658,53,30936,53,allow,785,110,675,2,30,1,1
56492,53,6474,53,allow,184,94,90,2,30,1,1
52163,443,4704,443,allow,4187,773,3414,16,30,9,7
56581,445,0,0,drop,66,66,0,1,0,1,0
59777,443,22920,443,allow,19311,2432,16879,55,417,24,31
53718,1053,4101,1053,allow,320,140,180,6,8,3,3
50840,443,34565,443,allow,8057,1135,6922,19,139,9,10
15274,81,0,0,deny,60,60,0,1,0,1,0
49730,445,0,0,drop,70,70,0,1,0,1,0
58498,445,0,0,drop,66,66,0,1,0,1,0
49418,32058,6170,32058,allow,78,78,0,1,30,1,0
55733,53,46441,53,allow,463,128,335,4,41,2,2
57470,18634,6347,18634,allow,594,594,0,10,1199,10,0
50484,445,0,0,drop,66,66,0,1,0,1,0
53544,445,0,0,drop,70,70,0,1,0,1,0
57169,53,55485,53,allow,177,94,83,2,30,1,1
15319,51505,0,0,deny,66,66,0,1,0,1,0
56765,53,1940,53,allow,188,96,92,2,31,1,1
53273,443,62514,443,allow,17169,6566,10603,52,37,24,28
56652,443,7084,443,allow,8006,1986,6020,20,15,11,9
56459,53,20811,53,allow,209,110,99,2,30,1,1
48420,54532,0,0,deny,146,146,0,1,0,1,0
49214,445,0,0,drop,70,70,0,1,0,1,0
